"a" = (/turf/unsimulated/mineral,/area/space)
"b" = (/turf/simulated/wall/covenant,/area/space)
"c" = (/turf/simulated/floor/covenant,/area/space)
"d" = (/turf/simulated/open,/area/space)
"e" = (/turf/simulated/floor/plating,/area/space)

(1,1,1) = {"
aaaaaaaaaaaaaaaaaaaaaaaaaaaaaaaaaaaaaaaaaaaaaaaaaaaaaaaaaaaaaaaaaaaaaaaaaaaaaaaaaaaaaaaaaaaaaaaaaaaa
aaaaaaaaaaaaaaaaaaaaaaaaaaaaaaaaaaaaaaaaaaaaaaaaaaaaaaaaaaaaaaaaaaaaaaaaaaaaaaaaaaaaaaaaaaaaaaaaaaaa
aaaaaaaaaaaaaaaaaaaaaaaaaaaaaaaaaaaaaaaaaaaaaaaaaaaaaaaaaaaaaaaaaaaaaaaaaaaaaaaaaaaaaaaaaaaaaaaaaaaa
aaaaaaaaaaaaaaaaaaaaaaaaaaaaaaaaaaaaaaaaaaaaaaaaaaaaaaaaaaaaaaaaaaaaaaaaaaaaaaaaaaaaaaaaaaaaaaaaaaaa
aaaaaaaaaaaaaaaaaaaaaaaaaaaaaaaaaaaaaaaaaaaaaaaaaaaaaaaaaaaaaaaaaaaaaaaaaaaaaaaaaaaaaaaaaaaaaaaaaaaa
aaaaaaaaaaaaaaaaaaaaaaaaaaaaaaaaaaaaaaaaaaaaaaaaaaaaaaaaaaaaaaaaaaaaaaaaaaaaaaaaaaaaaaaaaaaaaaaaaaaa
aaaaaaaaaaaaaaaaaaaaaaaaaaaaaaaaaaaaaaaaaaaaaaaaaaaaaaaaaaaaaaaaaaaaaaaaaaaaaaaaaaaaaaaaaaaaaaaaaaaa
aaaaaaaaaaaaaaaaaaaaaaaaaaaaaaaaaaaaaaaaaaaaaaaaaaaaaaaaaaaaaaaaaaaaaaaaaaaaaaaaaaaaaaaaaaaaaaaaaaaa
aaaaaaaaaaaaaaaaaaaaaaaaaaaaaaaaaaaaaaaaaaaaaaaaaaaaaaaaaaaaaaaaaaaaaaaaaaaaaaaaaaaaaaaaaaaaaaaaaaaa
aaaaaaaaaaaaaaaaaaaaaaaaaaaaaaaaaaaaaaaaaaaaaaaaaaaaaaaaaaaaaaaaaaaaaaaaaaaaaaaaaaaaaaaaaaaaaaaaaaaa
aaaaaaaaaaaaaaaaaaaaaaaaaaaaaaaaaaaaaaaaaaaaaaaaaaaaaaaaaaaaaaaaaaaaaaaaaaaaaaaaaaaaaaaaaaaaaaaaaaaa
aaaaaaaaaaaaaaaaaaaaaaaaaaaaaaaaaaaaaaaaaaaaaaaaaaaaaaaaaaaaaaaaaaaaaaaaaaaaaaaaaaaaaaaaaaaaaaaaaaaa
aaaaaaaaaaaaaaaaaaaaaaaaaaaaaaaaaaaaaaaaaaaaaaaaaaaaaaaaaaaaaaaaaaaaaaaaaaaaaaaaaaaaaaaaaaaaaaaaaaaa
aaaaaaaaaaaaaaaaaaaaaaaaaaaaaaaaaaaaaaaaaaaaaaaaaaaaaaaaaaaaaaaaaaaaaaaaaaaaaaaaaaaaaaaaaaaaaaaaaaaa
aaaaaaaaaaaaaaaaaaaaaaaaaaaaaaaaaaaaaaaaaaaaaaaaaaaaaaaaaaaaaaaaaaaaaaaaaaaaaaaaaaaaaaaaaaaaaaaaaaaa
aaaaaaaaaaaaaaaaaaaaaaaaaaaaaaaaaaaaaaaaaaaaaaaaaaaaaaaaaaaaaaaaaaaaaaaaaaaaaaaaaaaaaaaaaaaaaaaaaaaa
aaaaaaaaaaaaaaaaaaaaaaaaaaaaaaaaaaaaaaaaaaaaaaaaaaaaaaaaaaaaaaaaaaaaaaaaaaaaaaaaaaaaaaaaaaaaaaaaaaaa
aaaaaaaaaaaaaaaaaaaaaaaaaabbbbbbbbbbbbbbaaaaaaaaaaaaaaaaaaaaaaaaaaaaaaaaaaaaaaaaaaaaaaaaaaaaaaaaaaaa
aaaaaaaaaaaaaaaaaaaaaaaaaabccccccccccccbaaaaaaaaaaaaaaaaaaaaaaaaaaaaaaaaaaaaaaaaaaaaaaaaaaaaaaaaaaaa
aaaaaaaaaaaaaaaaaaaaaaaaaabccccccccccccbaaaaaaaaaaaaaaaaaaaaaaaaaaaaaaaaaaaaaaaaaaaaaaaaaaaaaaaaaaaa
aaaaaaaaaaaaaaaaaaaaaaaaaabccccccccccccbaaaaaaaaaaaaaaaaaaaaaaaaaaaaaaaaaaaaaaaaaaaaaaaaaaaaaaaaaaaa
aaaaaaaaaaaaaaaaaaaaaaaaaabccccccccccccbaaaaaaaaaaaaaaaaaaaaaaaaaaaaaaaaaaaaaaaaaaaaaaaaaaaaaaaaaaaa
aaaaaaaaaaaaaaaaaaaaaaaaaabccccccccccccbaaaaaaaaaaaaaaaaaaaaaaaaaaaaaaaaaaaaaaaaaaaaaaaaaaaaaaaaaaaa
aaaaaaaaaaaaaaaaaaaaaaaaaabccccccccccccbaaaaaaaaaaaaaaaaaaaaaaaaaaaaaaaaaaaaaaaaaaaaaaaaaaaaaaaaaaaa
aaaaaaaaaaaaaaaaaaaaaaaaaabccccccccccccbaaaaaaaaaaaaaaaaaaaaaaaaaaaaaaaaaaaaaaaaaaaaaaaaaaaaaaaaaaaa
aaaaaaaaaaaaaaaaaaaaaaaaaabccccccccccccbaaaaaaaaaaaaaaaaaaaaaaaaaaaaaaaaaaaaaaaaaaaaaaaaaaaaaaaaaaaa
aaaaaaaaaaaaaaaaaaaaaaaaaabccccccccccccbaaaaaaaaaaaaaaaaaaaaaaaaaaaaaaaaaaaaaaaaaaaaaaaaaaaaaaaaaaaa
aaaaaaaaaaaaaaaaaaaaaaaaaabccccccccccccbaaaaaaaaaaaaaaaaaaaaaaaaaaaaaaaaaaaaaaaaaaaaaaaaaaaaaaaaaaaa
aaaaaaaaaaaaaaaaaaaaaaaaaabccccccccccccbaaaaaaaaaaaaaaaaaaaaaaaaaaaaaaaaaaaaaaaaaaaaaaaaaaaaaaaaaaaa
aaaaaaaaaaaaaaaaaaaaaaaaaabccccccccccccbaaaaaaaaaaaaaaaaaaaaaaaaaaaaaaaaaaaaaaaaaaaaaaaaaaaaaaaaaaaa
aaaaaaaaaaaaaaaaaaaaaaaaaabbbbbbbbbbbbbbaaaaaaaaaaaaaaaaaaaaaaaaaaaaaaaaaaaaaaaaaaaaaaaaaaaaaaaaaaaa
aaaaaaaaaaaaaaaaaaaaaaaaaaaaaaaaaaaaaaaaaaaaaaaaaaaaaaaaaaaaaaaaaaaaaaaaaaaaaaaaaaaaaaaaaaaaaaaaaaaa
aaaaaaaaaaaaaaaaaaaaaaaaaaaaaaaaaaaaaaaaaaaaaaaaaaaaaaaaaaaaaaaaaaaaaaaaaaaaaaaaaaaaaaaaaaaaaaaaaaaa
aaaaaaaaaaaaaaaaaaaaaaaaaaaaaaaaaaaaaaaaaaaaaaaaaaaaaaaaaaaaaaaaaaaaaaaaaaaaaaaaaaaaaaaaaaaaaaaaaaaa
aaaaaaaaaaaaaaaaaaaaaaaaaaaaaaaaaaaaaaaaaaaaaaaaaaaaaaaaaaaaaaaaaaaaaaaaaaaaaaaaaaaaaaaaaaaaaaaaaaaa
aaaaaaaaaaaaaaaaaaaaaaaaaaaaaaaaaaaaaaaaaaaaaaaaaaaaaaaaaaaaaaaaaaaaaaaaaaaaaaaaaaaaaaaaaaaaaaaaaaaa
aaaaaaaaaaaaaaaaaaaaaaaaaaaaaaaaaaaaaaaaaaaaaaaaaaaaaaaaaaaaaaaaaaaaaaaaaaaaaaaaaaaaaaaaaaaaaaaaaaaa
aaaaaaaaaaaaaaaaaaaaaaaaaaaaaaaaaaaaaaaaaaaaaaaaaaaaaaaaaaaaaaaaaaaaaaaaaaaaaaaaaaaaaaaaaaaaaaaaaaaa
aaaaaaaaaaaaaaaaaaaaaaaaaaaaaaaaaaaaaaaaaaaaaaaaaaaaaaaaaaaaaaaaaaaaaaaaaaaaaaaaaaaaaaaaaaaaaaaaaaaa
aaaaaaaaaaaaaaaaaaaaaaaaaaaaaaaaaaaaaaaaaaaaaaaaaaaaaaaaaaaaaaaaaaaaaaaaaaaaaaaaaaaaaaaaaaaaaaaaaaaa
aaaaaaaaaaaaaaaaaaaaaaaaaaaaaaaaaaaaaaaaaaaaaaaaaaaaaaaaaaaaaaaaaaaaaaaaaaaaaaaaaaaaaaaaaaaaaaaaaaaa
aaaaaaaaaaaaaaaaaaaaaaaaaaaaaaaaaaaaaaaaaaaaaaaaaaaaaaaaaaaaaaaaaaaaaaaaaaaaaaaaaaaaaaaaaaaaaaaaaaaa
aaaaaaaaaaaaaaaaaaaaaaaaaaaaaaaaaaaaaaaaaaaaaaaaaaaaaaaaaaaaaaaaaaaaaaaaaaaaaaaaaaaaaaaaaaaaaaaaaaaa
aaaaaaaaaaaaaaaaaaaaaaaaaaaaaaaaaaaaaaaaaaaaaaaaaaaaaaaaaaaaaaaaaaaaaaaaaaaaaaaaaaaaaaaaaaaaaaaaaaaa
aaaaaaaaaaaaaaaaaaaaaaaaaaaaaaaaaaaaaaaaaaaaaaaaaaaaaaaaaaaaaaaaaaaaaaaaaaaaaaaaaaaaaaaaaaaaaaaaaaaa
aaaaaaaaaaaaaaaaaaaaaaaaaaaaaaaaaaaaaaaaaaaaaaaaaaaaaaaaaaaaaaaaaaaaaaaaaaaaaaaaaaaaaaaaaaaaaaaaaaaa
aaaaaaaaaaaaaaaaaaaaaaaaaaaaaaaaaaaaaaaaaaaaaaaaaaaaaaaaaaaaaaaaaaaaaaaaaaaaaaaaaaaaaaaaaaaaaaaaaaaa
aaaaaaaaaaaaaaaaaaaaaaaaaaaaaaaaaaaaaaaaaaaaaaaaaaaaaaaaaaaaaaaaaaaaaaaaaaaaaaaaaaaaaaaaaaaaaaaaaaaa
aaaaaaaaaaaaaaaaaaaaaaaaaaaaaaaaaaaaaaaaaaaaaaaaaaaaaaaaaaaaaaaaaaaaaaaaaaaaaaaaaaaaaaaaaaaaaaaaaaaa
aaaaaaaaaaaaaaaaaaaaaaaaaaaaaaaaaaaaaaaaaaaaaaaaaaaaaaaaaaaaaaaaaaaaaaaaaaaaaaaaaaaaaaaaaaaaaaaaaaaa
aaaaaaaaaaaaaaaaaaaaaaaaaaaaaaaaaaaaaaaaaaaaaaaaaaaaaaaaaaaaaaaaaaaaaaaaaaaaaaaaaaaaaaaaaaaaaaaaaaaa
aaaaaaaaaaaaaaaaaaaaaaaaaaaaaaaaaaaaaaaaaaaaaaaaaaaaaaaaaaaaaaaaaaaaaaaaaaaaaaaaaaaaaaaaaaaaaaaaaaaa
aaaaaaaaaaaaaaaaaaaaaaaaaaaaaaaaaaaaaaaaaaaaaaaaaaaaaaaaaaaaaaaaaaaaaaaaaaaaaaaaaaaaaaaaaaaaaaaaaaaa
aaaaaaaaaaaaaaaaaaaaaaaaaaaaaaaaaaaaaaaaaaaaaaaaaaaaaaaaaaaaaaaaaaaaaaaaaaaaaaaaaaaaaaaaaaaaaaaaaaaa
aaaaaaaaaaaaaaaaaaaaaaaaaaaaaaaaaaaaaaaaaaaaaaaaaaaaaaaaaaaaaaaaaaaaaaaaaaaaaaaaaaaaaaaaaaaaaaaaaaaa
aaaaaaaaaaaaaaaaaaaaaaaaaaaaaaaaaaaaaaaaaaaaaaaaaaaaaaaaaaaaaaaaaaaaaaaaaaaaaaaaaaaaaaaaaaaaaaaaaaaa
aaaaaaaaaaaaaaaaaaaaaaaaaaaaaaaaaaaaaaaaaaaaaaaaaaaaaaaaaaaaaaaaaaaaaaaaaaaaaaaaaaaaaaaaaaaaaaaaaaaa
aaaaaaaaaaaaaaaaaaaaaaaaaaaaaaaaaaaaaaaaaaaaaaaaaaaaaaaaaaaaaaaaaaaaaaaaaaaaaaaaaaaaaaaaaaaaaaaaaaaa
aaaaaaaaaaaaaaaaaaaaaaaaaaaaaaaaaaaaaaaaaaaaaaaaaaaaaaaaaaaaaaaaaaaaaaaaaaaaaaaaaaaaaaaaaaaaaaaaaaaa
aaaaaaaaaaaaaaaaaaaaaaaaaaaaaaaaaaaaaaaaaaaaaaaaaaaaaaaaaaaaaaaaaaaaaaaaaaaaaaaaaaaaaaaaaaaaaaaaaaaa
aaaaaaaaaaaaaaaaaaaaaaaaaaaaaaaaaaaaaaaaaaaaaaaaaaaaaaaaaaaaaaaaaaaaaaaaaaaaaaaaaaaaaaaaaaaaaaaaaaaa
aaaaaaaaaaaaaaaaaaaaaaaaaaaaaaaaaaaaaaaaaaaaaaaaaaaaaaaaaaaaaaaaaaaaaaaaaaaaaaaaaaaaaaaaaaaaaaaaaaaa
aaaaaaaaaaaaaaaaaaaaaaaaaaaaaaaaaaaaaaaaaaaaaaaaaaaaaaaaaaaaaaaaaaaaaaaaaaaaaaaaaaaaaaaaaaaaaaaaaaaa
aaaaaaaaaaaaaaaaaaaaaaaaaaaaaaaaaaaaaaaaaaaaaaaaaaaaaaaaaaaaaaaaaaaaaaaaaaaaaaaaaaaaaaaaaaaaaaaaaaaa
aaaaaaaaaaaaaaaaaaaaaaaaaaaaaaaaaaaaaaaaaaaaaaaaaaaaaaaaaaaaaaaaaaaaaaaaaaaaaaaaaaaaaaaaaaaaaaaaaaaa
aaaaaaaaaaaaaaaaaaaaaaaaaaaaaaaaaaaaaaaaaaaaaaaaaaaaaaaaaaaaaaaaaaaaaaaaaaaaaaaaaaaaaaaaaaaaaaaaaaaa
aaaaaaaaaaaaaaaaaaaaaaaaaaaaaaaaaaaaaaaaaaaaaaaaaaaaaaaaaaaaaaaaaaaaaaaaaaaaaaaaaaaaaaaaaaaaaaaaaaaa
aaaaaaaaaaaaaaaaaaaaaaaaaaaaaaaaaaaaaaaaaaaaaaaaaaaaaaaaaaaaaaaaaaaaaaaaaaaaaaaaaaaaaaaaaaaaaaaaaaaa
aaaaaaaaaaaaaaaaaaaaaaaaaaaaaaaaaaaaaaaaaaaaaaaaaaaaaaaaaaaaaaaaaaaaaaaaaaaaaaaaaaaaaaaaaaaaaaaaaaaa
aaaaaaaaaaaaaaaaaaaaaaaaaaaaaaaaaaaaaaaaaaaaaaaaaaaaaaaaaaaaaaaaaaaaaaaaaaaaaaaaaaaaaaaaaaaaaaaaaaaa
aaaaaaaaaaaaaaaaaaaaaaaaaaaaaaaaaaaaaaaaaaaaaaaaaaaaaaaaaaaaaaaaaaaaaaaaaaaaaaaaaaaaaaaaaaaaaaaaaaaa
aaaaaaaaaaaaaaaaaaaaaaaaaaaaaaaaaaaaaaaaaaaaaaaaaaaaaaaaaaaaaaaaaaaaaaaaaaaaaaaaaaaaaaaaaaaaaaaaaaaa
aaaaaaaaaaaaaaaaaaaaaaaaaaaaaaaaaaaaaaaaaaaaaaaaaaaaaaaaaaaaaaaaaaaaaaaaaaaaaaaaaaaaaaaaaaaaaaaaaaaa
aaaaaaaaaaaaaaaaaaaaaaaaaaaaaaaaaaaaaaaaaaaaaaaaaaaaaaaaaaaaaaaaaaaaaaaaaaaaaaaaaaaaaaaaaaaaaaaaaaaa
aaaaaaaaaaaaaaaaaaaaaaaaaaaaaaaaaaaaaaaaaaaaaaaaaaaaaaaaaaaaaaaaaaaaaaaaaaaaaaaaaaaaaaaaaaaaaaaaaaaa
aaaaaaaaaaaaaaaaaaaaaaaaaaaaaaaaaaaaaaaaaaaaaaaaaaaaaaaaaaaaaaaaaaaaaaaaaaaaaaaaaaaaaaaaaaaaaaaaaaaa
aaaaaaaaaaaaaaaaaaaaaaaaaaaaaaaaaaaaaaaaaaaaaaaaaddddddddaaaaaaaaaaaaaaaaaaaaaaaaaaaaaaaaaaaaaaaaaaa
aaaaaaaaaaaaaaaaaaaaaaaaaaaaaaaaaaaaaaaaaaaaaaaadddddddddddaaaaaaaaaadaaaaaaaaaaaaaaaaaaaaaaaaaaaaaa
aaaaaaaaaaaaaaaaaaaaaaaaadddddddaaaaaaaaaaaaaaadddddddddddddddaaaddddddaaaaaaaaaaaaaaaaaaaaaaaaaaaaa
aaaadaaaaaaaaaaaaaaaaaaadddddddddaaaaaaaaaaaaaaddddddddddddddddddddddddaaaaaaaaaaaaaaaaaaaaaaaaaaaaa
aaaddddaadddaaaaaaaadddddddddddddaaaaaaaaaaaaaadddddddddddddddddddddddddaaaaaaaaaaaaaaaaaaaaaaaaaaaa
aaaddddddddddddaaaaadddddddddddddaaaaaaaaaaaaaadddddddddddddddddddddddddddaaaaaaaaaaaaaaaaaaaaaaaaaa
aadddddddddddddddddddddddddddddddaadddddddaaddddddddddddddddddddddddddddddaaaaaaaaaaaaaaaaaaaaaaaaaa
aaddddddddddddddddddddddddddddddddddddddddddddddddddddddddddddddddddddddddaaaaaaaaaaaaaaaaaaaaaaaaaa
aaddddddddddddddddddddddddddddddddddddddddddddddddddddddddddddddddddddddaaaaaaaaaaaaaaaaaaaaaaaaaaaa
aaddddddddddddddddddddddddddddddddddddddddddddddddddddddddddddddddddddddaaaaaaaaaaaaaaaaaaaaaaaaaaaa
aaaddddddddddddddddddddddddddddddddddddddddddddddddddddddddddddddddddddaaaaaaaaaaaaaaaaaaaaaaaaaaaaa
aaaddddddddddddddddddddddddddddddddddddddddddddddddddddddddddddddddddddaaaaaaaaaaaaaaaaaaaaaaaaaaaaa
aaadddddddddddddddddddddddddddeeeeeedddddddddddddddddddddddddddddddddddaaaaaaaaaaaaaaaaaaaaaaaaaaaaa
aaadddddddddddddddddddddddddddeeeeeedddddddddddddddddddddddddddddddddddaaaaaaaaaaaaaaaaaaaaaaaaaaaaa
aaddddddddddddddddddddddddddddeeeeeedddddddddddddddddddddddddddddddddddddaaaaaaaaaaaaaaaaaaaaaaaaaaa
aaddddddddddddddddddddddddddddeeeeeeddddddddddddddddddddddddddddddddddddddaaaaaaaaaaaaaaaaaaaaaaaaaa
ddddddddddddddddddddddddddddddeeeeeeddddddddddddddddddddddddddddddddddddddaaaaaaaaaaaaaaaaaaaaaaaaaa
ddddddddddddddddddddddddddddddeeeeeedddddddddddddddddddddddddddddddddddddddaaaaaaaaaaaaaaaaaaaaaaaaa
ddddddddddddddddddddddddddddddddddddddddddddddddddddddddddddddddddddddddddaaaaaaaaaaaaaaaaaaaaaaaaaa
dddddddddddddddeeeeeedddddddddddddddddddddddddddddddddddddddddddddddddddddaaaaaaaaaaaaaaaaaaaaaaaaaa
dddddddddddddddeeeeeedddddddddddddddddddddddddddddddddddddddddddddddddddddaaaaaaaaaaaaaaaaaaaaaaaaaa
dddddddddddddddeeeeeedddddddddddddddddddddddddddddddddddddddddddddddddddddaaaaaaaaaaaaaaaaaaaaaaaaaa
dddddddddddddddeeeeeedddddddddddddddddddddddeeeeeeeeeeeeeeedddddddddddddddaaaaaaaaaaaaaaaaaaaaaaaaaa
dddddddddddddddeeeeeedddddddddddddddddddddddeeeeeeeeeeeeeeeddddddddddddddddaaaaaaaaaaaaaaaaaaaaaaaaa
dddddddddddddddeeeeeedddddddddddddddddddddddeeeeeeeeeeeeeeeddddddddddddddddaaaaaaaaaaaaaaaaaaaaaaaaa
ddddddddddddddddddddddddddddddddddddddddddddeeeeeeeeeeeeeeedddddddddddddddddaaaaaaaaaaaaaaaaaaaaaaaa
ddddddddddddddddddddddddddddddddddddddddddddeeeeeeeeeeeeeeedddddddddddddddddaaaaaaaaaaaaaaaaaaaaaaaa
ddddddddddddddddddddddddddddddddddddddddddddeeeeeeeeeeeeeeeddddddddddddddddddaaaaaaaaaaaaaaaaaaaaaaa
ddddddddddddddddddddddddddddddddddddddddeeeeeeeeeeeeeeeeeeeeeeeddddddddddddddaaaaaaaaaaaaaaaaaaaaaaa
ddddddddddddddddddddddddddddddddddddddddeeeeeeeeeeeeeeeeeeeeeeeddddddddddddddddaaaaaaaaaaaaaaaaaaaaa
ddddddddddddddddddddddddddddddddddddddddeeeeeeeeeeeeeeeeeeeeeeeddddddddddddddddaaaaaaaaaaaaaaaaaaaaa
ddddddddddddddddddddddddddddddddddddddddeeeeeeeeeeeeeeeeeeeeeeedddddddddddddddddddaaaaaaaaaaaaaaaaaa
ddddddddddddddddddddddddddddddddddddddddeeeeeeeeeeeeeeeeeeeeeeeddddddddddddddddddddaaaaaaaaaaaaaaaaa
ddddddddddddddddddddddddddddddddddddddddeeeeeeeeeeeeeeeeeeeeeeeddddddddddddddddddddddaaaaaaaaaaaaaaa
ddddddddddddddddddddddddddddddddddddddddeeeeeeeeeeeeeeeeeeeeeeedddddddddddddddddddddddaaaaaaaaaaaaaa
ddddddddddddddddddddddddddddddddddddddddeeeeeeeeeeeeeeeeeeeeeeedddddddddddddddddddddddaaaaaaaaaaaaaa
ddddddddddddddddddddddddddddddddddddddddeeeeeeeeeeeeeeeeeeeeeeeddddddddddddddddddddddddaaaaaaaaaaaaa
ddddddddddddddddddddddddddddddddddddddddeeeeeeeeeeeeeeeeeeeeeeeddddddddddddddddddddddddaaaaaaaaaaaaa
ddddddddddddddddddddddddddddddddddddddddeeeeeeeeeeeeeeeeeeeeeeeddddddddddddddddddddddddaaaaaaaaaaaaa
ddddddddddddddddddddddddddddddddddddddddddddeeeeeeeeeeeeeeeddddddddddddddddddddddddddddddaaaaaaaaaaa
ddddddddddddddddddddddddddddddddddddddddddddeeeeeeeeeeeeeeeddddddddddddddddddddddddddddddaaaaaaaaaaa
ddddddddddddddddddddddddddddddddddddddddddddeeeeeeeeeeeeeeedddddddddddddddddddddddddddddddddaaaaaaaa
ddddddddddddddddddddddddddddddddddddddddddddeeeeeeeeeeeeeeeddddddddddddddddddddddddddddddddddddaaaaa
ddddddddddddddddddddddddddddddddddddddddddddeeeeeeeeeeeeeeeddddddddddddddddddddddddddddddddddddaaaaa
ddddddddddddddddddddddddddddddddddddddddddddeeeeeeeeeeeeeeedddddddddddddddddddddddddddddddddddddaaaa
dddddddddddddddddddddddddddddddddddddddddddddddddddddddddddddddddddddddddddddddddddeeedeeeeddddddaaa
dddddddddddddddddddddddddddddddddddddddddddddddddddddddddddddddddddddddddddddddddddeeeddeeeddddddaaa
dddddddddddddddddddddddddddddddddddddddddddddddddddddddddddddddddddddddddddddddddddeddddddeddddddaaa
ddddddddddddddddddddddddddddddddddddddddddddddddddddddddddddddddddddddddddddddddddddddedddddddddddda
ddddddddddddddddddddddddddddddddddddddddddddddddddddddddddddddddddddddddddddddddddddddddddddddddddda
dddddddddddddddddddddddddddddddddddddddddddddddddddddddddddddddddddddddddddddddddddeedddeeedddddddda
addddddddddddddddddddddddddddddddddddddddddddddddddddddddddddddddddddddddddddddddddeeeeeeeedddddddda
aaaddddddddddddddddddddddddddddddddddddddddddddddddddddddddddddddddddeeeeeddddddddddddddddddddddddda
aaaaddddaaaadddddddddddddddddddddddddddddddaaaaaaddddddddddddddddddddeeeeeddddddddddddddddddddddddda
aaaaaaddaaaaddddddddddddddddddddddddaaaaaaaaaaaaaddddddddddddddddddddeeeeeddddddddddddddddddddddddda
aaaaaadaaaaaaddddddddddddddddddddddaaaaaaaaaaaaaaddddddddddddddddddddeeeeeddddddddddddddddddddddddaa
aaaaaaaaaaaaadddddddddddddddddddaaaaaaaaaaaaaaaaaddddddddddddddddddddeeeeeddddddddddddddddddddddddaa
aaaaaaaaaaaaaddddddddddddddddddaaaaaaaaaaaaaaaaaadddddddddddddddddddddddddddddddddddddddddddddddddaa
aaaaaaaaaaaaaadddddddddddaaaaaaaaaaaaaaaaaaaaaaaaaaddddddddddddddddddddddddddddddddddeeeeeeeeeeeedaa
aaaaaaaaaaaaaadddddddddddaaaaaaaaaaaaaaaaaaaaaaaaaaddddddddddddddddddddddddddddddddddeeeeeeeeeeeedda
aaaaaaaaaaaaaadddddddddddaaaaaaaaaaaaaaaaaaaaaaaaaaddddddddddddddddddddddddddddddddddeeeeeeeeeeeedda
aaaaaaaaaaaaaadddddddddddaaaaaaaaaaaaaaaaaaaaaaaaaaddddddddddddddddddddddddddddddddddeeeeeeeeeeeedda
aaaaaaaaaaaaaddddddddddddaaaaaaaaaaaaaaaaaaaaaaaaaaaaadddddddddddddddddddddddddddddddeeeeeeeeeeeedda
aaaaaaaaaaaaaddddddddddddaaaaaaaaaaaaaaaaaaaaaaaaaaaaaaaaddddddddddddddddddddddddddddeeeeeeeddddddda
aaaaaaaaaaaaadddddddddddddaaaaaaaaaaaaaaaaaaaaaaaaaaaaaaaaaadddddddeeeeeeddddddddddddeeeeeeeddddddda
aaaaaaaaaaadddddddddddddddaaaaaaaaaaaaaaaaaaaaaaaaaaaaaaaaaaaddddddeeeeeeddddddddddddeeeeeeeddddddda
aaaaaaaaaaadddddddddddddddaaaaaaaaaaaaaaaaaaaaaaaaaaaaaaaaaaaddddddeeeeeeddddddddddddeeeeeeeddddddda
aaaaaaaaaaadddddddddddddddaaaaaaaaaaaaaaaaaaaaaaaaaaaaaaaaaaaddddddeeeeeedddddddddddddddddddddddddaa
aaaaaadaaddddddddddddddddddaaaaaaaaaaaaaaaaaaaaaaaaaaaaaaaaaaddddddeeeeeedddddddddddddddddddddddddaa
aaaaaadddddddddddddddddddddaaaaaaaaaaaaaaaaaaaaaaaaaaaaaaaaaaddddddeeeeeeddddddddddddddddddddddddaaa
adddddddddddddddddddddddddddddaaaaaaaaaaaaaaaaaaaaaaaaaaaaaaaddddddddddddddddddddddddddddddddddddaaa
ddddddddddddddddddddddddddddddaaaaaaaaaaaaadddddaaaaaaaaaaaaaaaddddddddddddddddddddddddddddddddddaaa
ddeeeeeeddddddddddddddddddddddaaaaaaaaaaadddddddaaaaaaaaaaaaaaaddddddddddddddddddddddddddddddddddaaa
ddeeeeeeddddddddddddddddddddddaaaaaaaaaaadddddddaaaaaaaaaaaaaaaddddddddddddddddddddddddddddddddddaaa
ddeeeeeedddddddddddddddddddddddaaaaaaaaaadddddddaaaaaaaaaaaaaaaddddddddddddddddddddddddddddddddddaaa
ddeeeeeedddddddddddddddddddddddddaaaaaaadddddddddddaaaaaaaaaaaadddddddddddddddddddddddddddddddddddda
ddeeeeeedddddddddddddddddddddddddaaaaaaddddddddddddddddaaaaaaaddddddddddddddddddddddddddddddddddddda
ddeeeeeedddddddddddddddddddddddddddaaaaddddddddddddddddaaaaaaaddddddddddddddddddddddddddddddddddddda
ddddddddddddddaaaddddddddddddddddddddddddddddddddddddddaaaaaaaddddddaaaaadddddddddddddddddddddddddda
ddddddddddddddaaadddddddddddddddddddddddddddddddddddddddddaaaaddddddaaaaaddaaaadddddddddddddddddddda
ddddddddddddaaaaadddddddddddddddddddddddddddddddddddddddddddddddddddaaaaaadaaaadddddddddddddddddddaa
ddddddddddddaaaaaaddddddddddddddddddddddddddddddddddddddddddddddddddaaaaaaaaaaadddddddddddddddddddaa
dddddddddddaaaaaaaddddddddddddddddddddddddddddddddddddddddddddddddaaaaaaaaaaaaaddddddddddddddddddaaa
dddddddddddaaaaaaaadddddddddddddddddddddddddddddddddddddddddddddddaaaaaaaaaaaaaddddddddddddddddddaaa
dddddddddddaaaaaaaadddddddddddddddddddddddddddddddddddddddddddddddaaaaaaaaaaaaaaaddddddddddddddaaaaa
dddddddddddaaaaaaaaddddddddddddddddddddddddddddddddddddddddddddddaaaaaaaaaaaaaaaaadddddddddddddaaaaa
dddddddddddaaaaaaaaddddddddddddddddddddddddddddddddddddddddddddddaaaaaaaaaaaaaaaaadddddddddddddaaaaa
ddddddddddddddaaaaaddddddddddddddddddddddddddddddddddddddddddddddaaaaaaaaaaaaaaaaadddddddddddddaaaaa
ddddddddddddddaadddddddddddddddddddddddddddddddddddddddddddddddaaaaaaaaaaaaaaaaaaaddddddddddddddaaaa
dddddddddddddddddddddddddddddddddddddddddddddddddddddddddddddddaaaaaaaaaaaaaaaaaaaddddddddddddddaaaa
dddddddddddddddddddddddddddddddddddddddddddddddddddddddddddddddaaaaaaaaaaaaaaaaadddddddddddddddddaaa
dddddddddddddddddddddddddddddddddddddddddddddddddddddddddddddddaaaaaaaaaaaaaaaaadddddddddddddddddaaa
dddddddddddddddddddddddddddddddddddddddddddddddddddddddddddddddaaaaaaaaaaaaaaadddddddddddddddddddaaa
ddddddddddddddddddddddddddddddddddddddddddddddddddddddddddddddddddaaaaaaaaaaaadddddddddddddddddddaaa
dddddddddddddddddddddddddddddddddddddddddddddddddddddddddddddddddddaaaadadddddddddddddddddddddddddaa
dddddddddddddddddddddddddddddddddddddddddddddddddddddddddddddddddddaaaddddddddddddddddddddddddddddaa
dddddddddddddddddddddddddddddddddddddddddddddddddddddddddddddddddddddddddddddddadddddddddddddddddaaa
dddddddddddeeeeddddddddddddddddddddddddddddddddddddddddddddddddddddddddddddddaaadddddddddddddddddaaa
dddddddddddeeeddddddddddddddddddddddddddddddddddddddddddddddddddddddddddddddaaaaddddddddddddddddddaa
dddddddddddeeeededddddddddddddddddddddddddddddddddddddddddddddddddddddddddddaaaaadddddddddddddddddda
dddddddddddeeeeeeddddddddddddddddddddddddddddddddddddddddddddddddddddddddddddaaaadddddddddddddddddaa
dddddddddddeeeeeeddddddddddddddddddddddddddddddddddddddddddddddddddddddddddddaddddddddddddddddddddaa
addddddddddeeeeeedddddddddddddddddddddddddddddddddddddddddddddddddddddddddddddddddddddddddddddddddaa
aaadddddddddddddddddddddddddddddddddddddddddddddddddddddddddddddddddddddddddddddddddddddddddddddddaa
aaaaddddddddddddddddddddddddddddddddddddddddddddddddddddddddddddddddddddddddddddddddddddddddddddddda
aaaaddddddddddddddddddddddddddddddddddddddddddddddddddddddddddddddddddddddddddddddddddddddddddddddda
aaaadddddddddaaaddddddddddddddddddddddddddddddddddddddddddddddddddddddddddddddddddddddddddddddadddda
aaaadddddaaaaaaaaaddddddddddddddddddddddddddddddddddddddddddddddddddddddddddddddddddddddddddddaaddda
aaaadddddaaaaaaaaaadddddddddddddddddddddddddddddddddddddddddddddddddddddddddddddddddddddddddaaaaddaa
aaadddddaaaaaaaaaaaddddddddddddddddddddddddddddddddddddddddddddddaadddddddddddddddddddddddaaaaaadaaa
aaaaddaaaaaaaaaaaaaadddddddddddddddddddddddddddddddddddddddddaaddaadddddddddddddddddddddddaaaaaadaaa
aaaaaaaaaaaaaaaaaaaaddddddddddddddddddddddddddddddddddddddaaaaaddadddddddddddddddddddddddddaaaaddaaa
aaaaaaaaaaaaaaaaaaaaaaddddddddddddddddddddddddddddddddddddaaaaaddddddddddddddddddddddddddddddaaddaaa
aaaaaaaaaaaaaaaaaaaaaadddddddddddddddddddddddddddddddddddaaaaaaaddddddddddddddddddddddddddddddddddaa
aaaaaaaaaaaaaaaaaaaaaaaaaddddddddddddddddddddddddddddddddaaaaaaaadddddddddddddddddddddddddddddddddaa
aaaaaaaaaaaaaaaaaaaaaaaaaaaddddddddddddddddddddddddddddddddaaaaaadddddddddddddddddddddddddddddddddaa
aaaaaaaaaaaaaaaaaaaaaaaaaaaaaaaddddddddddddddddddddddddddddaaaaaadddddddddddddddddddddddddddddddddda
aaaaaaaaaaaaaaaaaaaaaaaaaaaaaaaaddddddddddddddddddddddddddddaaadddddddddddddddddddddddddddddddddddda
aaaaaaaaaaaaaaaaaaaaaaaaaaaaaaaaadddddddaaaaaaaadddddddddddddaadddddddddddddddddddddddddddddddddddda
aaaaaaaaaaaaaaaaaaaaaaaaaaaaaaaaddddddddaaaaaaaaddddddddddddddddddddddddddddddddddddddddddddddddddda
aaaaaaaaaaaaaaaaaaaaaaaaaaaaaaaaddddddaaaaaaaaaaaaaaddddddddddddddddddddddddddddddddddddddddddddddda
aaaaaaaaaaaaaaaaaaaaaaaaaaaaaaaaadddaaaaaaaaaaaaaaaaddddddddddddddddddddddddddddddddddddddddddddddda
aaaaaaaaaaaaaaaaaaaaaaaaaaaaaaaaaaaaaaaaaaaaaaaaaaaaddddddddddddddddddddddddddddddddddddddddddddddaa
aaaaaaaaaaaaaaaaaaaaaaaaaaaaaaaaaaaaaaaaaaaaaaaaaaaaaddddddddddddddddddddddddddddddddddddddddddddaaa
"}
