"aa" = (/turf/unsimulated/wall,/area/planets/house/upper)
"ab" = (/turf/simulated/open,/area/planets/house/upper)
"ac" = (/turf/simulated/floor/tiled,/area/planets/house/upper)
"ad" = (/turf/simulated/wall/plastic/hospital,/area/planets/house/upper)
"ae" = (/obj/structure/girder,/turf/simulated/floor/plating,/area/planets/house/upper)
"af" = (/obj/structure/window/framed,/turf/simulated/floor/decor{tag = "icon-arrival (WEST)"; icon_state = "arrival"; dir = 8},/area/planets/house/upper)
"ag" = (/obj/structure/window/framed,/turf/simulated/floor/tiled,/area/planets/house/upper)
"ah" = (/obj/structure/window/framed,/turf/simulated/floor/decor{tag = "icon-arrival (EAST)"; icon_state = "arrival"; dir = 4},/area/planets/house/upper)
"ai" = (/obj/structure/window/framed,/turf/simulated/floor/tiled/white,/area/planets/house/upper)
"aj" = (/turf/simulated/floor/tiled/white,/area/planets/house/upper)
"ak" = (/obj/item/weapon/storage/firstaid/toxin,/obj/item/weapon/storage/firstaid/toxin,/obj/item/weapon/storage/firstaid/toxin,/obj/item/weapon/storage/firstaid/toxin,/obj/structure/table/standard,/obj/machinery/light{dir = 8},/turf/simulated/floor/tiled/white,/area/planets/house/upper)
"al" = (/turf/simulated/floor/decor{tag = "icon-arrival (WEST)"; icon_state = "arrival"; dir = 8},/area/planets/house/upper)
"am" = (/obj/structure/repair_bench,/turf/simulated/floor/tiled,/area/planets/house/upper)
"an" = (/obj/structure/bed/chair/wheelchair,/turf/simulated/floor/decor{tag = "icon-arrival (EAST)"; icon_state = "arrival"; dir = 4},/area/planets/house/upper)
"ao" = (/obj/structure/bed/chair/wheelchair,/obj/machinery/light{dir = 4; icon_state = "tube1"},/turf/simulated/floor/tiled/white,/area/planets/house/upper)
"ap" = (/obj/machinery/chem_master,/turf/simulated/floor/tiled/white,/area/planets/house/upper)
"aq" = (/obj/structure/bed/chair/office/light{tag = "icon-officechair_white_preview (WEST)"; icon_state = "officechair_white_preview"; dir = 8},/turf/simulated/floor/decor{tag = "icon-arrival (WEST)"; icon_state = "arrival"; dir = 8},/area/planets/house/upper)
"ar" = (/obj/machinery/chemical_dispenser/full,/obj/effect/floor_decal/corner/lime{tag = "icon-corner_white (NORTHEAST)"; icon_state = "corner_white"; dir = 5},/turf/simulated/floor/tiled/white,/area/planets/house/upper)
"as" = (/obj/structure/bed/chair/office/light{tag = "icon-officechair_white_preview (EAST)"; icon_state = "officechair_white_preview"; dir = 4},/turf/simulated/floor/decor{tag = "icon-arrival (EAST)"; icon_state = "arrival"; dir = 4},/area/planets/house/upper)
"at" = (/obj/machinery/chem_master,/obj/structure/sign/warning/nosmoking_1{pixel_y = 32},/turf/simulated/floor/tiled/white,/area/planets/house/upper)
"au" = (/obj/structure/closet/crate/large,/turf/simulated/floor/tiled/white,/area/planets/house/upper)
"av" = (/obj/machinery/firealarm{dir = 2; pixel_y = 24},/obj/structure/closet/secure_closet/personal/patient,/turf/simulated/floor/tiled/white,/area/planets/house/upper)
"aw" = (/obj/machinery/iv_drip,/turf/simulated/floor/tiled/white,/area/planets/house/upper)
"ax" = (/obj/item/weapon/storage/firstaid/fire,/obj/item/weapon/storage/firstaid/fire,/obj/item/weapon/storage/firstaid/fire,/obj/item/weapon/storage/firstaid/fire,/obj/structure/table/standard,/turf/simulated/floor/tiled/white,/area/planets/house/upper)
"ay" = (/turf/simulated/floor/decor{tag = "icon-arrival (EAST)"; icon_state = "arrival"; dir = 4},/area/planets/house/upper)
"az" = (/obj/machinery/button/remote/blast_door{dir = 8; id = "chemblast"; name = "Chemistry Shutter Control"; pixel_x = -32},/turf/simulated/floor/tiled/white,/area/planets/house/upper)
"aA" = (/obj/structure/table/standard,/obj/item/weapon/storage/box/beakers,/turf/simulated/floor/tiled,/area/planets/house/upper)
"aB" = (/obj/item/weapon/storage/box/beakers,/obj/structure/table/standard,/obj/item/weapon/storage/briefcase/colossuscase,/turf/simulated/floor/tiled,/area/planets/house/upper)
"aC" = (/obj/machinery/smartfridge/chemistry,/turf/simulated/floor/tiled/white,/area/planets/house/upper)
"aD" = (/obj/item/device/radio/intercom{dir = 0; name = "Station Intercom (General)"; pixel_x = -27},/obj/item/weapon/stool,/obj/machinery/light/colored/red{icon_state = "red1"; dir = 4},/turf/simulated/floor/tiled/white,/area/planets/house/upper)
"aE" = (/obj/item/weapon/bedsheet/medical,/obj/machinery/vending/wallmed1{name = "NanoMed Wall"; pixel_x = 25; pixel_y = 0},/obj/structure/bed/padded,/turf/simulated/floor/tiled/white,/area/planets/house/upper)
"aF" = (/obj/item/weapon/bedsheet/medical,/obj/structure/bed/padded,/turf/simulated/floor/tiled/white,/area/planets/house/upper)
"aG" = (/obj/item/device/radio/intercom{dir = 0; name = "Station Intercom (General)"; pixel_x = -27},/obj/item/weapon/stool,/turf/simulated/floor/tiled/white,/area/planets/house/upper)
"aH" = (/obj/item/weapon/bedsheet/medical,/obj/machinery/vending/wallmed1{name = "NanoMed Wall"; pixel_x = 25; pixel_y = 0},/obj/structure/bed/padded,/obj/machinery/light/colored/red{dir = 8},/turf/simulated/floor/tiled/white,/area/planets/house/upper)
"aI" = (/obj/item/weapon/storage/firstaid/adv,/obj/item/weapon/storage/firstaid/adv,/obj/item/weapon/storage/firstaid/adv,/obj/item/weapon/storage/firstaid/adv,/obj/item/weapon/storage/firstaid/adv,/obj/structure/table/standard,/turf/simulated/floor/tiled/white,/area/planets/house/upper)
"aJ" = (/obj/structure/table/standard,/obj/item/device/healthanalyzer,/obj/item/device/healthanalyzer,/turf/simulated/floor/tiled,/area/planets/house/upper)
"aK" = (/obj/random/firstaid,/obj/random/firstaid,/obj/structure/table/standard,/turf/simulated/floor/tiled,/area/planets/house/upper)
"aL" = (/obj/item/bodybag/cryobag,/obj/structure/table/glass,/turf/simulated/floor/tiled/white,/area/planets/house/upper)
"aM" = (/obj/structure/table/steel,/obj/item/weapon/storage/firstaid/adv,/obj/item/weapon/storage/firstaid/adv,/obj/item/weapon/storage/firstaid/adv,/obj/item/weapon/storage/firstaid/adv,/obj/item/weapon/storage/firstaid/adv,/obj/machinery/light/colored/red{icon_state = "red1"; dir = 4},/turf/simulated/floor/tiled/white,/area/planets/house/upper)
"aN" = (/obj/item/weapon/storage/box/autoinjectors,/obj/item/weapon/storage/box/autoinjectors,/obj/structure/table/standard,/turf/simulated/floor/tiled,/area/planets/house/upper)
"aO" = (/obj/item/weapon/storage/box/pillbottles,/obj/item/weapon/storage/box/pillbottles,/obj/item/weapon/storage/box/pillbottles,/obj/structure/table/standard,/turf/simulated/floor/tiled,/area/planets/house/upper)
"aP" = (/obj/machinery/hologram/holopad,/turf/simulated/floor/decor{tag = "icon-arrival (EAST)"; icon_state = "arrival"; dir = 4},/area/planets/house/upper)
"aQ" = (/obj/machinery/button/remote/blast_door{dir = 4; id = "chemblast"; name = "Chemistry Shutter Control"; pixel_x = 32},/turf/simulated/floor/tiled/white,/area/planets/house/upper)
"aR" = (/obj/structure/barrel,/turf/simulated/floor/tiled/white,/area/planets/house/upper)
"aS" = (/obj/item/weapon/storage/box/bloodpacks,/obj/structure/table/glass,/turf/simulated/floor/tiled/white,/area/planets/house/upper)
"aT" = (/obj/structure/closet/wardrobe/chemistry_white,/turf/simulated/floor/tiled/white,/area/planets/house/upper)
"aU" = (/obj/structure/table/standard,/obj/item/weapon/pen,/obj/item/weapon/hand_labeler,/turf/simulated/floor/tiled,/area/planets/house/upper)
"aV" = (/obj/machinery/door/airlock/glass,/turf/simulated/floor/tiled/white,/area/planets/house/upper)
"aW" = (/obj/structure/curtain{color = "#72AFED"; name = "blue curtain"},/turf/simulated/floor/tiled/white,/area/planets/house/upper)
"aX" = (/obj/item/weapon/packageWrap,/obj/item/weapon/hand_labeler,/obj/machinery/atmospherics/unary/vent_pump/on,/obj/structure/table/standard,/turf/simulated/floor/tiled/white,/area/planets/house/upper)
"aY" = (/obj/machinery/hologram/holopad,/turf/simulated/floor/tiled,/area/planets/house/upper)
"aZ" = (/obj/structure/closet/secure_closet/freezer{name = "blood storage"},/obj/item/weapon/reagent_containers/blood/AMinus,/obj/item/weapon/reagent_containers/blood/APlus,/obj/item/weapon/reagent_containers/blood/BMinus,/obj/item/weapon/reagent_containers/blood/BPlus,/obj/item/weapon/reagent_containers/blood/OMinus,/obj/item/weapon/reagent_containers/blood/OPlus,/obj/structure/table/glass,/turf/simulated/floor/tiled/white,/area/planets/house/upper)
"ba" = (/obj/structure/table/standard,/obj/item/weapon/storage/firstaid/unsc,/obj/item/weapon/storage/firstaid/unsc,/obj/item/weapon/storage/firstaid/unsc,/obj/item/weapon/storage/firstaid/unsc,/obj/item/weapon/storage/firstaid/combat,/obj/item/weapon/storage/firstaid/combat,/obj/item/weapon/storage/firstaid/combat,/obj/item/weapon/storage/firstaid/combat,/turf/simulated/floor/tiled/white,/area/planets/house/upper)
"bb" = (/obj/structure/table/standard,/obj/item/weapon/storage/firstaid/unsc,/obj/item/weapon/storage/firstaid/unsc,/obj/item/weapon/storage/firstaid/unsc,/obj/item/weapon/storage/firstaid/unsc,/turf/simulated/floor/tiled/white,/area/planets/house/upper)
"bc" = (/obj/structure/sign/chemistry,/turf/simulated/wall/plastic/hospital,/area/planets/house/upper)
"bd" = (/obj/machinery/light/colored/red{icon_state = "red1"; dir = 1},/turf/simulated/floor/tiled/white,/area/planets/house/upper)
"be" = (/obj/structure/table/standard,/obj/item/weapon/plastique,/obj/item/weapon/plastique,/turf/simulated/floor/tiled/white,/area/planets/house/upper)
"bf" = (/obj/structure/table/standard,/turf/simulated/floor/tiled/white,/area/planets/house/upper)
"bg" = (/obj/structure/table/standard,/obj/machinery/light/colored/red{icon_state = "red1"; dir = 1},/turf/simulated/floor/tiled/white,/area/planets/house/upper)
"bh" = (/obj/structure/destructible/tanktrap,/turf/simulated/floor/tiled/white,/area/planets/house/upper)
"bi" = (/obj/item/device/radio/intercom{dir = 0; name = "Station Intercom (General)"; pixel_x = -27},/obj/item/weapon/reagent_containers/glass/bottle/stoxin{pixel_x = -6; pixel_y = 10},/obj/item/weapon/reagent_containers/glass/bottle/antitoxin{pixel_x = 5; pixel_y = 5},/obj/item/weapon/reagent_containers/glass/bottle/inaprovaline{pixel_x = 1},/obj/machinery/atmospherics/pipe/simple/hidden/supply,/obj/structure/table/standard,/turf/simulated/floor/tiled/white,/area/planets/house/upper)
"bj" = (/obj/item/roller,/obj/item/roller,/obj/item/roller,/obj/structure/table/glass,/turf/simulated/floor/tiled/white,/area/planets/house/upper)
"bk" = (/obj/machinery/door/airlock/multi_tile/glass{dir = 1; name = "Medical Storage"; req_access = list(66)},/turf/simulated/floor/tiled,/area/planets/house/upper)
"bl" = (/obj/structure/table/standard,/obj/item/weapon/airlock_brace,/obj/item/weapon/airlock_brace,/obj/item/weapon/airlock_brace,/turf/simulated/floor/tiled/white,/area/planets/house/upper)
"bm" = (/obj/structure/destructible/steel_barricade{icon_state = "barricade2"; dir = 4},/turf/simulated/floor/tiled/white,/area/planets/house/upper)
"bn" = (/obj/item/weapon/storage/firstaid/toxin{pixel_x = 5; pixel_y = 5},/obj/item/weapon/storage/firstaid/toxin,/obj/machinery/atmospherics/pipe/simple/hidden/supply{dir = 5},/obj/structure/table/standard,/turf/simulated/floor/tiled/white,/area/planets/house/upper)
"bo" = (/obj/item/weapon/storage/box/beakers,/obj/item/weapon/storage/box/syringes{pixel_x = 4; pixel_y = 4},/obj/item/weapon/storage/box/syringes,/obj/structure/table/glass,/turf/simulated/floor/tiled/white,/area/planets/house/upper)
"bp" = (/obj/effect/landmark/start/defenders,/turf/simulated/floor/tiled/white,/area/planets/house/upper)
"bq" = (/obj/structure/table/steel_reinforced,/obj/item/weapon/weldpack,/obj/item/weapon/weldingtool,/turf/simulated/floor/tiled/white,/area/planets/house/upper)
"br" = (/obj/structure/bed/chair/office/light{tag = "icon-officechair_white_preview (WEST)"; icon_state = "officechair_white_preview"; dir = 8},/obj/effect/landmark/start/defenders,/turf/simulated/floor/tiled/white,/area/planets/house/upper)
"bs" = (/obj/structure/turret/chaingun{icon_state = "chaingunturret"; dir = 4},/turf/simulated/floor/tiled/white,/area/planets/house/upper)
"bt" = (/obj/item/weapon/storage/firstaid/regular{pixel_x = 5; pixel_y = 5},/obj/item/weapon/storage/firstaid/regular,/obj/machinery/light_switch{pixel_x = -23; pixel_y = 0},/obj/structure/table/standard,/turf/simulated/floor/tiled/white,/area/planets/house/upper)
"bu" = (/obj/item/weapon/storage/box/bodybags,/obj/item/weapon/storage/box/bodybags,/obj/structure/table/standard,/turf/simulated/floor/tiled,/area/planets/house/upper)
"bv" = (/obj/item/weapon/storage/box/beakers,/obj/structure/table/standard,/turf/simulated/floor/tiled,/area/planets/house/upper)
"bw" = (/obj/item/weapon/storage/box/gloves{pixel_x = 4; pixel_y = 4},/obj/item/weapon/storage/box/masks{pixel_y = 0},/obj/structure/table/glass,/turf/simulated/floor/tiled/white,/area/planets/house/upper)
"bx" = (/obj/structure/table/standard,/turf/simulated/floor/tiled,/area/planets/house/upper)
"by" = (/obj/item/taperoll/medical,/obj/structure/table/standard,/turf/simulated/floor/tiled,/area/planets/house/upper)
"bz" = (/obj/structure/closet/secure_closet/medical1,/obj/item/weapon/storage/backpack/dufflebag/med,/obj/item/weapon/storage/backpack/dufflebag/med,/obj/item/weapon/storage/backpack/dufflebag/med,/turf/simulated/floor/tiled/white,/area/planets/house/upper)
"bA" = (/obj/machinery/light/colored/red,/turf/simulated/floor/tiled/white,/area/planets/house/upper)
"bB" = (/obj/structure/table/standard,/obj/machinery/light/colored/red,/obj/item/weapon/wirecutters,/obj/item/weapon/wrench,/turf/simulated/floor/tiled/white,/area/planets/house/upper)
"bC" = (/obj/structure/closet/crate/large,/obj/item/stack/material/wood/fifty,/obj/item/stack/material/steel/fifty,/turf/simulated/floor/tiled/white,/area/planets/house/upper)
"bD" = (/obj/machinery/vending/medical,/turf/simulated/floor/tiled/white,/area/planets/house/upper)
"bE" = (/obj/machinery/door/airlock/glass{name = "Medical Storage"},/turf/simulated/floor/tiled/white,/area/planets/house/upper)
"bF" = (/obj/structure/table/steel_reinforced,/turf/simulated/floor/tiled/white,/area/planets/house/upper)
"bG" = (/obj/structure/closet/secure_closet/chemical,/obj/item/weapon/storage/box/pillbottles,/obj/item/device/radio/headset/headset_med,/obj/structure/table/standard,/obj/machinery/light{dir = 8},/turf/simulated/floor/tiled/white,/area/planets/house/upper)
"bH" = (/obj/structure/closet/crate/large,/obj/item/stack/barbedwire/ten,/obj/item/stack/barbedwire/ten,/obj/item/stack/material/plasteel/ten,/turf/simulated/floor/tiled/white,/area/planets/house/upper)
"bI" = (/obj/machinery/autolathe/ammo_fabricator,/turf/simulated/floor/tiled/white,/area/planets/house/upper)
"bJ" = (/obj/machinery/vending/armory/attachment,/turf/simulated/floor/tiled/white,/area/planets/house/upper)
"bK" = (/obj/machinery/door/airlock/medical{name = "Operation Theatre 2"},/turf/simulated/floor/tiled/white,/area/planets/house/upper)
"bL" = (/obj/structure/closet/secure_closet/medical2,/obj/machinery/light{dir = 8},/turf/simulated/floor/decor{tag = "icon-whitebluefull"; icon_state = "whitebluefull"},/area/planets/house/upper)
"bM" = (/obj/machinery/oxygen_pump/anesthetic{pixel_y = 32},/turf/simulated/floor/decor{tag = "icon-whitebluefull"; icon_state = "whitebluefull"},/area/planets/house/upper)
"bN" = (/obj/structure/sink{name = "interior sink"; pixel_y = 32},/turf/simulated/floor/tiled/white,/area/planets/house/upper)
"bO" = (/turf/simulated/floor/decor{tag = "icon-whitebluefull"; icon_state = "whitebluefull"},/area/planets/house/upper)
"bP" = (/obj/machinery/iv_drip,/turf/simulated/floor/decor{tag = "icon-whitebluefull"; icon_state = "whitebluefull"},/area/planets/house/upper)
"bQ" = (/obj/item/weapon/reagent_containers/food/snacks/popcorn,/obj/structure/table/standard,/turf/simulated/floor/decor{tag = "icon-arrival (WEST)"; icon_state = "arrival"; dir = 8},/area/planets/house/upper)
"bR" = (/obj/machinery/organ_printer/robot/mapped,/obj/structure/capture_marker{pixel_y = 32},/turf/simulated/floor/tiled,/area/planets/house/upper)
"bS" = (/obj/machinery/organ_printer/robot/mapped,/turf/simulated/floor/decor{tag = "icon-arrival (EAST)"; icon_state = "arrival"; dir = 4},/area/planets/house/upper)
"bT" = (/obj/structure/destructible/steel_barricade,/turf/simulated/floor/tiled/white,/area/planets/house/upper)
"bU" = (/obj/structure/repair_bench,/turf/simulated/floor/tiled/white,/area/planets/house/upper)
"bV" = (/obj/structure/table/steel,/obj/item/weapon/FixOVein,/obj/item/weapon/surgicaldrill,/turf/simulated/floor/decor{tag = "icon-whitebluefull"; icon_state = "whitebluefull"},/area/planets/house/upper)
"bW" = (/turf/simulated/floor/decor{tag = "icon-whiteblue (WEST)"; icon_state = "whiteblue"; dir = 8},/area/planets/house/upper)
"bX" = (/turf/simulated/floor/decor{tag = "icon-whiteblue (EAST)"; icon_state = "whiteblue"; dir = 4},/area/planets/house/upper)
"bY" = (/obj/structure/table/steel,/obj/item/weapon/reagent_containers/spray/cleaner{desc = "Someone has crossed out the Space from Space Cleaner and written in Surgery. 'Do not remove under punishment of death!!!' is scrawled on the back."; name = "Surgery Cleaner"},/turf/simulated/floor/decor{tag = "icon-whitebluefull"; icon_state = "whitebluefull"},/area/planets/house/upper)
"bZ" = (/obj/effect/wingrille_spawn/reinforced/full,/obj/machinery/door/blast/shutters/open{dir = 8; icon_state = "shutter1"; id = "surgery2"; name = "Surgery Shutters"; pixel_y = 0; req_access = list(45); tag = "icon-shutter1 (WEST)"},/turf/simulated/floor/tiled,/area/planets/house/upper)
"ca" = (/obj/structure/bed/chair{tag = "icon-chair_preview (WEST)"; icon_state = "chair_preview"; dir = 8},/turf/simulated/floor/decor{tag = "icon-arrival (WEST)"; icon_state = "arrival"; dir = 8},/area/planets/house/upper)
"cb" = (/obj/machinery/door/airlock/medical{name = "Observation Room"},/turf/simulated/floor/tiled,/area/planets/house/upper)
"cc" = (/obj/structure/table/steel,/obj/item/weapon/circular_saw{pixel_y = 8},/obj/item/weapon/scalpel,/turf/simulated/floor/decor{tag = "icon-whitebluefull"; icon_state = "whitebluefull"},/area/planets/house/upper)
"cd" = (/obj/machinery/optable,/turf/simulated/floor/tiled/white,/area/planets/house/upper)
"ce" = (/obj/structure/table/steel,/obj/item/clothing/mask/surgical,/obj/item/clothing/head/surgery/blue,/turf/simulated/floor/decor{tag = "icon-whitebluefull"; icon_state = "whitebluefull"},/area/planets/house/upper)
"cf" = (/obj/machinery/light{dir = 4; icon_state = "tube1"},/turf/simulated/floor/decor{tag = "icon-arrival (EAST)"; icon_state = "arrival"; dir = 4},/area/planets/house/upper)
"cg" = (/obj/structure/table/steel,/obj/item/stack/medical/advanced/bruise_pack,/obj/item/weapon/retractor,/obj/item/weapon/bonegel,/obj/item/weapon/bonesetter,/turf/simulated/floor/decor{tag = "icon-whitebluefull"; icon_state = "whitebluefull"},/area/planets/house/upper)
"ch" = (/obj/machinery/light/colored/red{icon_state = "red1"; dir = 4},/turf/simulated/floor/tiled/white,/area/planets/house/upper)
"ci" = (/obj/structure/destructible/marine_barricade{icon_state = "marine barricade"; dir = 1},/turf/simulated/floor/tiled/white,/area/planets/house/upper)
"cj" = (/obj/structure/table/steel,/obj/item/weapon/hemostat,/obj/item/weapon/cautery,/turf/simulated/floor/decor{tag = "icon-whitebluefull"; icon_state = "whitebluefull"},/area/planets/house/upper)
"ck" = (/obj/machinery/vending/wallmed1{pixel_y = -32},/obj/machinery/autosurgeon,/turf/simulated/floor/decor{tag = "icon-whiteblue (WEST)"; icon_state = "whiteblue"; dir = 8},/area/planets/house/upper)
"cl" = (/obj/machinery/button/remote/blast_door{id = "surgery2"; name = "Surgery Shutters"; pixel_y = -32},/turf/simulated/floor/tiled/white,/area/planets/house/upper)
"cm" = (/obj/structure/table/steel,/obj/item/weapon/storage/box/bodybags,/obj/item/weapon/defibrillator/loaded,/turf/simulated/floor/decor{tag = "icon-whiteblue (EAST)"; icon_state = "whiteblue"; dir = 4},/area/planets/house/upper)
"cn" = (/obj/machinery/computer/med_data,/obj/machinery/light{dir = 4; icon_state = "tube1"},/turf/simulated/floor/decor{tag = "icon-whitebluefull"; icon_state = "whitebluefull"},/area/planets/house/upper)
"co" = (/obj/structure/table/standard,/obj/item/weapon/reagent_containers/syringe/biofoam,/obj/item/weapon/reagent_containers/syringe/biofoam,/turf/simulated/floor/decor{tag = "icon-arrival (WEST)"; icon_state = "arrival"; dir = 8},/area/planets/house/upper)
"cp" = (/obj/machinery/power/breakerbox/activated,/turf/simulated/floor/tiled,/area/planets/house/upper)
"cq" = (/obj/structure/window/reinforced/full,/turf/simulated/floor/plating,/area/planets/house/upper)
"cr" = (/obj/structure/sign/greencross,/turf/simulated/wall/plastic/hospital,/area/planets/house/upper)
"cs" = (/obj/machinery/door/airlock/medical{name = "Medical Archives"; req_access = list(5)},/turf/simulated/floor/plating,/area/planets/house/upper)
"ct" = (/obj/structure/sink{icon_state = "sink"; dir = 8; pixel_x = -12; pixel_y = 2},/turf/simulated/floor/tiled/white,/area/planets/house/upper)
"cu" = (/obj/structure/table/standard,/obj/machinery/light{dir = 1; icon_state = "tube1"},/turf/simulated/floor/tiled/white,/area/planets/house/upper)
"cv" = (/obj/machinery/computer/med_data,/turf/simulated/floor/tiled/white,/area/planets/house/upper)
"cw" = (/obj/machinery/light{dir = 1; icon_state = "tube1"},/turf/simulated/floor/tiled/white,/area/planets/house/upper)
"cx" = (/obj/machinery/light{dir = 8},/turf/simulated/floor/tiled/white,/area/planets/house/upper)
"cy" = (/obj/structure/bed/chair/office/light,/turf/simulated/floor/tiled/white,/area/planets/house/upper)
"cz" = (/obj/structure/bookcase{name = "bookcase (Fiction)"},/turf/simulated/floor/tiled/white,/area/planets/house/upper)
"cA" = (/obj/structure/bed/chair/office/light{tag = "icon-officechair_white_preview (WEST)"; icon_state = "officechair_white_preview"; dir = 8},/turf/simulated/floor/tiled/white,/area/planets/house/upper)
"cB" = (/obj/structure/bed/chair/office/light{tag = "icon-officechair_white_preview (NORTH)"; icon_state = "officechair_white_preview"; dir = 1},/turf/simulated/floor/tiled/white,/area/planets/house/upper)
"cC" = (/obj/structure/bed/chair/office/light{tag = "icon-officechair_white_preview (EAST)"; icon_state = "officechair_white_preview"; dir = 4},/turf/simulated/floor/tiled/white,/area/planets/house/upper)
"cD" = (/obj/machinery/door/airlock/multi_tile/glass{name = "Meeting Room"},/turf/simulated/floor/tiled/white,/area/planets/house/upper)
"cE" = (/obj/structure/table/standard,/obj/machinery/light,/turf/simulated/floor/tiled/white,/area/planets/house/upper)
"cF" = (/obj/structure/filingcabinet/medical,/turf/simulated/floor/tiled/white,/area/planets/house/upper)
"cG" = (/obj/structure/ladder/down,/turf/simulated/floor/tiled/white,/area/planets/house/upper)
"cH" = (/obj/structure/bookcase{name = "bookcase (Fiction)"},/obj/machinery/light{dir = 4; icon_state = "tube1"},/turf/simulated/floor/tiled/white,/area/planets/house/upper)
"cI" = (/obj/structure/window/framed,/turf/simulated/floor/decor{tag = "icon-cmo"; icon_state = "cmo"},/area/planets/house/upper)

(1,1,1) = {"
aaaaaaaaaaaaaaaaaaaaaaaaaaaaaaaaaaaaaaaaaaaaaaaaaaaaaaaaaaaaaaaaaaaaaaaaaaaaaaaaaaaaaaaaaaaaaaaaaaaaaaaaaaaaaaaaaaaaaaaaaaaaaaaaaa
aaaaaaaaaaaaaaaaaaaaaaaaaaaaaaaaaaaaaaaaaaaaaaaaaaaaaaaaaaaaaaaaaaaaaaaaaaaaaaaaaaaaaaaaaaaaaaaaaaaaaaaaaaaaaaaaaaaaaaaaaaaaaaaaaa
aaaaaaaaaaaaaaaaaaaaaaaaaaaaaaaaaaaaaaaaaaaaaaaaaaaaaaaaaaaaaaaaaaaaaaaaaaaaaaaaaaaaaaaaaaaaaaaaaaaaaaaaaaaaaaaaaaaaaaaaaaaaaaaaaa
aaaaaaaaaaaaaaaaaaaaaaaaaaaaaaaaaaaaaaaaaaaaaaaaaaaaaaaaaaaaaaaaaaaaaaaaaaaaaaaaaaaaaaaaaaaaaaaaaaaaaaaaaaaaaaaaaaaaaaaaaaaaaaaaaa
aaaaaaaaababababababababababababababababababababababababababababababababababababababababababababababababababababababababaaaaaaaaaa
aaaaaaaaababababababababababababababababababababababababababababababababababababababababababababababababababababababababaaaaaaaaaa
aaaaaaaaababababababababababababababababababababababababababababababababababababababababababababababababababababababababaaaaaaaaaa
aaaaaaaaababababababababababababababababababababababababababababababababababababababababababababababababababababababababaaaaaaaaaa
aaaaaaaaabababababababababababacacacacacadadadadaeadadadadafagagahadadaiaiaiadadaiaiadadaiaiadadaiaiadadaiaiadajababababaaaaaaaaaa
aaaaaaaaabababababababababababacacacacacadakalacamanaoadapaqararasatadauajajadavajawadavajawaeavajawadavajawadajababababaaaaaaaaaa
aaaaaaaaabababababababababababacacacacacaeaxalacacayajadazalaAaBayajaCajajajadaDajaEadaDajaFaeaGajaEadaGajaHadajababababaaaaaaaaaa
aaaaaaaaabababababababababababacacacacacadaIalaJaKayaLadaMalaNaOaPaQadajajaRadajajajadajajajaeajajajadaRajajadajababababaaaaaaaaaa
aaaaaaaaabababababababababababacacacacacadajalaJaKayaSadaTalaUaUayajaVajajajadadaWaWadadaWaWadadaWaWadadaWaWadajababababaaaaaaaaaa
aaaaaaaaabababababababababababacacacacacadaXalacaYayaZadbaalacacaybbbcajajajbdajajajbebfajajbfbgbhajbfbfajajaiajababababaaaaaaaaaa
aaaaaaaaabababababababababababacacacacacadbialacacaybjadadadbkacadadadajajajbfblajajajbmajajajajajajajajajajaiajababababaaaaaaaaaa
aaaaaaaaabababababababababababacacacacacadbnalacacayboaebpajajajaRbqajajajajbfbrajajajbsajajajajajajajajajajaiajababababaaaaaaaaaa
aaaaaaaaabababababababababababacacacacacadbtalbubvaybwaeajajajajajajajajajajbfbfajajajbmajajajajajajajajajajaiajababababaaaaaaaaaa
aaaaaaaaabababababababababababacacacacacaeajalbxbyaybzadajajajajajajajajajajbAajajajbfbfajajbfbBajbCbfbfbhajaiajababababaaaaaaaaaa
aaaaaaaaabababababababababababacacacacacaebDalacacayajbEajajajajajajajajbpbFadadaWaWadadaWaWadadaeadadadaWaWadajababababaaaaaaaaaa
aaaaaaaaabababababababababababacacacacacadbGalacacanaoadajajbHbIbAajajajajbJadavajajadavajajadabababadavajajadajababababaaaaaaaaaa
aaaaaaaaabababababababababababacacacacacadaiaiaiadadadadbKadadadadadadajajajadaDajaEadaDajaEadabababadaGajaHadajababababaaaaaaaaaa
aaaaaaaaabababababababababababacacacacacacacacacadbLbMbNbObPadbQbRbSadbTajbTadajajawadbUajawadabababadajajawadajababababaaaaaaaaaa
aaaaaaaaabababababababababababacacacacacacacacacaibVbWajbXbYbZcaacaycbajajajadadaeadadadadadadabababadadadadadajababababaaaaaaaaaa
aaaaaaaaabababababababababababacacacacacacacacacaiccbWcdbXcebZcaaYcfadajajajbmajajajajajajbdajajajajajbdajauaiajababababaaaaaaaaaa
aaaaaaaaabababababababababababacacacacacacacacacaicgbWajbXbObZcaacayadchajajajajajajajajajajajciajciajajajajaiajababababaaaaaaaaaa
aaaaaaaaabababababababababababacacacacacacacacacadcjckclcmcnadcocpayadajbpajajajajajajajauajajajbpajajajajajaiajababababaaaaaaaaaa
aaaaaaaaabababababababababababacacacacadadaiaiaiadadadadadadadadadadadadcqcrcscradadadadadadadadadadctajajajaiajababababaaaaaaaaaa
aaaaaaaaabababababababababababababababadcubfcvajajajbfbfbfajcwajajajajajajajajcwadcxajcycycycyajczadajajajajaeajababababaaaaaaaaaa
aaaaaaaaabababababababababababababababadbfcAajajajajajcBajajajajajajajajajajajbfadajcCbfbfbfbfajajajajajajajaiajababababaaaaaaaaaa
aaaaaaaaabababababababababababababababadbfajajajajajajajajajajbfcyajbfajajajcybfadajajbfbfbfbfajajcDajajajajaiajababababaaaaaaaaaa
aaaaaaaaabababababababababababababababadcEbfcFcFcFcFcFcFcGcFcFbfbfbfbfajbfbfbfcEadajajcBcBcBcBajcHadaRajajbAadajababababaaaaaaaaaa
aaaaaaaaabababababababababababababababadadadadadadadadadadadadadadadaiaiaiaiadadadadadcIcIcIcIadadadadaeaeadadajababababaaaaaaaaaa
aaaaaaaaababababababababababababababababababababababababababababababababababababababababababababababababababababababababaaaaaaaaaa
aaaaaaaaababababababababababababababababababababababababababababababababababababababababababababababababababababababababaaaaaaaaaa
aaaaaaaaababababababababababababababababababababababababababababababababababababababababababababababababababababababababaaaaaaaaaa
aaaaaaaaababababababababababababababababababababababababababababababababababababababababababababababababababababababababaaaaaaaaaa
aaaaaaaaaaaaaaaaaaaaaaaaaaaaaaaaaaaaaaaaaaaaaaaaaaaaaaaaaaaaaaaaaaaaaaaaaaaaaaaaaaaaaaaaaaaaaaaaaaaaaaaaaaaaaaaaaaaaaaaaaaaaaaaaaa
aaaaaaaaaaaaaaaaaaaaaaaaaaaaaaaaaaaaaaaaaaaaaaaaaaaaaaaaaaaaaaaaaaaaaaaaaaaaaaaaaaaaaaaaaaaaaaaaaaaaaaaaaaaaaaaaaaaaaaaaaaaaaaaaaa
aaaaaaaaaaaaaaaaaaaaaaaaaaaaaaaaaaaaaaaaaaaaaaaaaaaaaaaaaaaaaaaaaaaaaaaaaaaaaaaaaaaaaaaaaaaaaaaaaaaaaaaaaaaaaaaaaaaaaaaaaaaaaaaaaa
aaaaaaaaaaaaaaaaaaaaaaaaaaaaaaaaaaaaaaaaaaaaaaaaaaaaaaaaaaaaaaaaaaaaaaaaaaaaaaaaaaaaaaaaaaaaaaaaaaaaaaaaaaaaaaaaaaaaaaaaaaaaaaaaaa
"}
