"aa" = (/turf/unsimulated/wall,/area/planets/house2/outdoor)
"ab" = (/turf/simulated/open,/area/planets/house2/outdoor)
"ac" = (/turf/simulated/floor/tiled,/area/planets/house2/outdoor)
"ad" = (/turf/simulated/wall/plastic/hospital,/area/planets/house2/indoor)
"ae" = (/obj/structure/girder,/turf/simulated/floor/plating,/area/planets/house2/indoor)
"af" = (/obj/structure/window/framed,/turf/simulated/floor/decor{tag = "icon-arrival (WEST)"; icon_state = "arrival"; dir = 8},/area/planets/house2/indoor)
"ag" = (/obj/structure/window/framed,/turf/simulated/floor/tiled,/area/planets/house2/indoor)
"ah" = (/obj/structure/window/framed,/turf/simulated/floor/decor{tag = "icon-arrival (EAST)"; icon_state = "arrival"; dir = 4},/area/planets/house2/indoor)
"ai" = (/obj/structure/window/framed,/turf/simulated/floor/tiled/white,/area/planets/house2/indoor)
"aj" = (/turf/simulated/floor/tiled/white,/area/planets/house2/outdoor)
"ak" = (/obj/item/weapon/storage/firstaid/toxin,/obj/item/weapon/storage/firstaid/toxin,/obj/item/weapon/storage/firstaid/toxin,/obj/item/weapon/storage/firstaid/toxin,/obj/structure/table/standard,/turf/simulated/floor/tiled/white,/area/planets/house2/indoor)
"al" = (/turf/simulated/floor/decor{tag = "icon-arrival (WEST)"; icon_state = "arrival"; dir = 8},/area/planets/house2/indoor)
"am" = (/turf/simulated/floor/tiled,/area/planets/house2/indoor)
"an" = (/obj/structure/repair_bench,/turf/simulated/floor/tiled,/area/planets/house2/indoor)
"ao" = (/obj/structure/bed/chair/wheelchair,/turf/simulated/floor/decor{tag = "icon-arrival (EAST)"; icon_state = "arrival"; dir = 4},/area/planets/house2/indoor)
"ap" = (/obj/structure/bed/chair/wheelchair,/obj/machinery/light{dir = 4; icon_state = "tube1"},/turf/simulated/floor/tiled/white,/area/planets/house2/indoor)
"aq" = (/obj/machinery/chem_master,/turf/simulated/floor/tiled/white,/area/planets/house2/indoor)
"ar" = (/obj/structure/bed/chair/office/light{tag = "icon-officechair_white_preview (WEST)"; icon_state = "officechair_white_preview"; dir = 8},/turf/simulated/floor/decor{tag = "icon-arrival (WEST)"; icon_state = "arrival"; dir = 8},/area/planets/house2/indoor)
"as" = (/obj/machinery/chemical_dispenser/full,/obj/effect/floor_decal/corner/lime{tag = "icon-corner_white (NORTHEAST)"; icon_state = "corner_white"; dir = 5},/turf/simulated/floor/tiled/white,/area/planets/house2/indoor)
"at" = (/obj/structure/bed/chair/office/light{tag = "icon-officechair_white_preview (EAST)"; icon_state = "officechair_white_preview"; dir = 4},/turf/simulated/floor/decor{tag = "icon-arrival (EAST)"; icon_state = "arrival"; dir = 4},/area/planets/house2/indoor)
"au" = (/obj/machinery/chem_master,/obj/structure/sign/warning/nosmoking_1{pixel_y = 32},/turf/simulated/floor/tiled/white,/area/planets/house2/indoor)
"av" = (/obj/structure/closet/crate/large,/turf/simulated/floor/tiled/white,/area/planets/house2/indoor)
"aw" = (/turf/simulated/floor/tiled/white,/area/planets/house2/indoor)
"ax" = (/obj/machinery/firealarm{dir = 2; pixel_y = 24},/obj/structure/closet/secure_closet/personal/patient,/turf/simulated/floor/tiled/white,/area/planets/house2/indoor)
"ay" = (/obj/machinery/iv_drip,/turf/simulated/floor/tiled/white,/area/planets/house2/indoor)
"az" = (/obj/item/weapon/storage/firstaid/fire,/obj/item/weapon/storage/firstaid/fire,/obj/item/weapon/storage/firstaid/fire,/obj/item/weapon/storage/firstaid/fire,/obj/structure/table/standard,/turf/simulated/floor/tiled/white,/area/planets/house2/indoor)
"aA" = (/turf/simulated/floor/decor{tag = "icon-arrival (EAST)"; icon_state = "arrival"; dir = 4},/area/planets/house2/indoor)
"aB" = (/obj/machinery/button/remote/blast_door{dir = 8; id = "chemblast"; name = "Chemistry Shutter Control"; pixel_x = -32},/turf/simulated/floor/tiled/white,/area/planets/house2/indoor)
"aC" = (/obj/structure/table/standard,/obj/item/weapon/storage/box/beakers,/turf/simulated/floor/tiled,/area/planets/house2/indoor)
"aD" = (/obj/item/weapon/storage/box/beakers,/obj/structure/table/standard,/obj/item/weapon/storage/briefcase/colossuscase,/turf/simulated/floor/tiled,/area/planets/house2/indoor)
"aE" = (/obj/machinery/smartfridge/chemistry,/turf/simulated/floor/tiled/white,/area/planets/house2/indoor)
"aF" = (/obj/structure/bed/chair/wheelchair,/turf/simulated/floor/tiled/white,/area/planets/house2/indoor)
"aG" = (/obj/item/weapon/bedsheet/medical,/obj/machinery/vending/wallmed1{name = "NanoMed Wall"; pixel_x = 25; pixel_y = 0},/obj/structure/bed/padded,/turf/simulated/floor/tiled/white,/area/planets/house2/indoor)
"aH" = (/obj/item/weapon/bedsheet/medical,/obj/structure/bed/padded,/turf/simulated/floor/tiled/white,/area/planets/house2/indoor)
"aI" = (/obj/item/device/radio/intercom{dir = 0; name = "Station Intercom (General)"; pixel_x = -27},/obj/item/weapon/stool,/turf/simulated/floor/tiled/white,/area/planets/house2/indoor)
"aJ" = (/obj/item/weapon/bedsheet/medical,/obj/machinery/vending/wallmed1{name = "NanoMed Wall"; pixel_x = 25; pixel_y = 0},/obj/structure/bed/padded,/obj/machinery/light/colored/red{dir = 8},/turf/simulated/floor/tiled/white,/area/planets/house2/indoor)
"aK" = (/obj/item/weapon/storage/firstaid/adv,/obj/item/weapon/storage/firstaid/adv,/obj/item/weapon/storage/firstaid/adv,/obj/item/weapon/storage/firstaid/adv,/obj/item/weapon/storage/firstaid/adv,/obj/structure/table/standard,/turf/simulated/floor/tiled/white,/area/planets/house2/indoor)
"aL" = (/obj/structure/table/standard,/obj/item/device/healthanalyzer,/obj/item/device/healthanalyzer,/turf/simulated/floor/tiled,/area/planets/house2/indoor)
"aM" = (/obj/random/firstaid,/obj/random/firstaid,/obj/structure/table/standard,/turf/simulated/floor/tiled,/area/planets/house2/indoor)
"aN" = (/obj/item/bodybag/cryobag,/obj/structure/table/glass,/turf/simulated/floor/tiled/white,/area/planets/house2/indoor)
"aO" = (/obj/structure/table/steel,/obj/item/weapon/storage/firstaid/adv,/obj/item/weapon/storage/firstaid/adv,/obj/item/weapon/storage/firstaid/adv,/obj/item/weapon/storage/firstaid/adv,/obj/item/weapon/storage/firstaid/adv,/obj/machinery/light/colored/red{icon_state = "red1"; dir = 4},/turf/simulated/floor/tiled/white,/area/planets/house2/indoor)
"aP" = (/obj/item/weapon/storage/box/autoinjectors,/obj/item/weapon/storage/box/autoinjectors,/obj/structure/table/standard,/turf/simulated/floor/tiled,/area/planets/house2/indoor)
"aQ" = (/obj/item/weapon/storage/box/pillbottles,/obj/item/weapon/storage/box/pillbottles,/obj/item/weapon/storage/box/pillbottles,/obj/structure/table/standard,/turf/simulated/floor/tiled,/area/planets/house2/indoor)
"aR" = (/obj/machinery/hologram/holopad,/turf/simulated/floor/decor{tag = "icon-arrival (EAST)"; icon_state = "arrival"; dir = 4},/area/planets/house2/indoor)
"aS" = (/obj/machinery/button/remote/blast_door{dir = 4; id = "chemblast"; name = "Chemistry Shutter Control"; pixel_x = 32},/turf/simulated/floor/tiled/white,/area/planets/house2/indoor)
"aT" = (/obj/structure/barrel,/turf/simulated/floor/tiled/white,/area/planets/house2/indoor)
"aU" = (/obj/item/weapon/storage/box/bloodpacks,/obj/structure/table/glass,/turf/simulated/floor/tiled/white,/area/planets/house2/indoor)
"aV" = (/obj/structure/closet/wardrobe/chemistry_white,/turf/simulated/floor/tiled/white,/area/planets/house2/indoor)
"aW" = (/obj/structure/table/standard,/obj/item/weapon/pen,/obj/item/weapon/hand_labeler,/turf/simulated/floor/tiled,/area/planets/house2/indoor)
"aX" = (/obj/machinery/door/airlock/glass,/turf/simulated/floor/tiled/white,/area/planets/house2/indoor)
"aY" = (/obj/structure/curtain{color = "#72AFED"; name = "blue curtain"},/turf/simulated/floor/tiled/white,/area/planets/house2/indoor)
"aZ" = (/obj/item/weapon/packageWrap,/obj/item/weapon/hand_labeler,/obj/machinery/atmospherics/unary/vent_pump/on,/obj/structure/table/standard,/turf/simulated/floor/tiled/white,/area/planets/house2/indoor)
"ba" = (/obj/machinery/hologram/holopad,/turf/simulated/floor/tiled,/area/planets/house2/indoor)
"bb" = (/obj/structure/closet/secure_closet/freezer{name = "blood storage"},/obj/item/weapon/reagent_containers/blood/AMinus,/obj/item/weapon/reagent_containers/blood/APlus,/obj/item/weapon/reagent_containers/blood/BMinus,/obj/item/weapon/reagent_containers/blood/BPlus,/obj/item/weapon/reagent_containers/blood/OMinus,/obj/item/weapon/reagent_containers/blood/OPlus,/obj/structure/table/glass,/turf/simulated/floor/tiled/white,/area/planets/house2/indoor)
"bc" = (/obj/structure/table/standard,/obj/item/weapon/storage/firstaid/unsc,/obj/item/weapon/storage/firstaid/unsc,/obj/item/weapon/storage/firstaid/unsc,/obj/item/weapon/storage/firstaid/unsc,/obj/item/weapon/storage/firstaid/combat,/obj/item/weapon/storage/firstaid/combat,/obj/item/weapon/storage/firstaid/combat,/obj/item/weapon/storage/firstaid/combat,/turf/simulated/floor/tiled/white,/area/planets/house2/indoor)
"bd" = (/obj/structure/table/standard,/obj/item/weapon/storage/firstaid/unsc,/obj/item/weapon/storage/firstaid/unsc,/obj/item/weapon/storage/firstaid/unsc,/obj/item/weapon/storage/firstaid/unsc,/turf/simulated/floor/tiled/white,/area/planets/house2/indoor)
"be" = (/obj/structure/sign/chemistry,/turf/simulated/wall/plastic/hospital,/area/planets/house2/indoor)
"bf" = (/obj/machinery/light/colored/red{icon_state = "red1"; dir = 1},/turf/simulated/floor/tiled/white,/area/planets/house2/indoor)
"bg" = (/obj/structure/table/standard,/obj/item/weapon/plastique,/obj/item/weapon/plastique,/turf/simulated/floor/tiled/white,/area/planets/house2/indoor)
"bh" = (/obj/structure/table/standard,/turf/simulated/floor/tiled/white,/area/planets/house2/indoor)
"bi" = (/obj/structure/table/standard,/obj/machinery/light/colored/red{icon_state = "red1"; dir = 1},/turf/simulated/floor/tiled/white,/area/planets/house2/indoor)
"bj" = (/obj/structure/destructible/tanktrap,/turf/simulated/floor/tiled/white,/area/planets/house2/indoor)
"bk" = (/obj/item/device/radio/intercom{dir = 0; name = "Station Intercom (General)"; pixel_x = -27},/obj/item/weapon/reagent_containers/glass/bottle/stoxin{pixel_x = -6; pixel_y = 10},/obj/item/weapon/reagent_containers/glass/bottle/antitoxin{pixel_x = 5; pixel_y = 5},/obj/item/weapon/reagent_containers/glass/bottle/inaprovaline{pixel_x = 1},/obj/machinery/atmospherics/pipe/simple/hidden/supply,/obj/structure/table/standard,/turf/simulated/floor/tiled/white,/area/planets/house2/indoor)
"bl" = (/obj/item/roller,/obj/item/roller,/obj/item/roller,/obj/structure/table/glass,/turf/simulated/floor/tiled/white,/area/planets/house2/indoor)
"bm" = (/obj/machinery/door/airlock/multi_tile/glass{dir = 1; name = "Medical Storage"; req_access = newlist()},/turf/simulated/floor/tiled,/area/planets/house2/indoor)
"bn" = (/obj/structure/table/standard,/obj/item/weapon/airlock_brace,/obj/item/weapon/airlock_brace,/obj/item/weapon/airlock_brace,/turf/simulated/floor/tiled/white,/area/planets/house2/indoor)
"bo" = (/obj/structure/destructible/steel_barricade{icon_state = "barricade2"; dir = 4},/turf/simulated/floor/tiled/white,/area/planets/house2/indoor)
"bp" = (/obj/item/weapon/storage/firstaid/toxin{pixel_x = 5; pixel_y = 5},/obj/item/weapon/storage/firstaid/toxin,/obj/machinery/atmospherics/pipe/simple/hidden/supply{dir = 5},/obj/structure/table/standard,/turf/simulated/floor/tiled/white,/area/planets/house2/indoor)
"bq" = (/obj/item/weapon/storage/box/beakers,/obj/item/weapon/storage/box/syringes{pixel_x = 4; pixel_y = 4},/obj/item/weapon/storage/box/syringes,/obj/structure/table/glass,/turf/simulated/floor/tiled/white,/area/planets/house2/indoor)
"br" = (/obj/effect/landmark/start/defenders,/turf/simulated/floor/tiled/white,/area/planets/house2/indoor)
"bs" = (/obj/structure/table/steel_reinforced,/obj/item/weapon/weldpack,/obj/item/weapon/weldingtool,/turf/simulated/floor/tiled/white,/area/planets/house2/indoor)
"bt" = (/obj/structure/bed/chair/office/light{tag = "icon-officechair_white_preview (WEST)"; icon_state = "officechair_white_preview"; dir = 8},/obj/effect/landmark/start/defenders,/turf/simulated/floor/tiled/white,/area/planets/house2/indoor)
"bu" = (/obj/structure/turret/chaingun{icon_state = "chaingunturret"; dir = 4},/turf/simulated/floor/tiled/white,/area/planets/house2/indoor)
"bv" = (/obj/item/weapon/storage/firstaid/regular{pixel_x = 5; pixel_y = 5},/obj/item/weapon/storage/firstaid/regular,/obj/machinery/light_switch{pixel_x = -23; pixel_y = 0},/obj/structure/table/standard,/turf/simulated/floor/tiled/white,/area/planets/house2/indoor)
"bw" = (/obj/item/weapon/storage/box/bodybags,/obj/item/weapon/storage/box/bodybags,/obj/structure/table/standard,/turf/simulated/floor/tiled,/area/planets/house2/indoor)
"bx" = (/obj/item/weapon/storage/box/beakers,/obj/structure/table/standard,/turf/simulated/floor/tiled,/area/planets/house2/indoor)
"by" = (/obj/item/weapon/storage/box/gloves{pixel_x = 4; pixel_y = 4},/obj/item/weapon/storage/box/masks{pixel_y = 0},/obj/structure/table/glass,/turf/simulated/floor/tiled/white,/area/planets/house2/indoor)
"bz" = (/obj/structure/table/standard,/turf/simulated/floor/tiled,/area/planets/house2/indoor)
"bA" = (/obj/item/taperoll/medical,/obj/structure/table/standard,/turf/simulated/floor/tiled,/area/planets/house2/indoor)
"bB" = (/obj/structure/closet/secure_closet/medical1,/obj/item/weapon/storage/backpack/dufflebag/med,/obj/item/weapon/storage/backpack/dufflebag/med,/obj/item/weapon/storage/backpack/dufflebag/med,/turf/simulated/floor/tiled/white,/area/planets/house2/indoor)
"bC" = (/obj/machinery/light/colored/red,/turf/simulated/floor/tiled/white,/area/planets/house2/indoor)
"bD" = (/obj/structure/table/standard,/obj/machinery/light/colored/red,/obj/item/weapon/wirecutters,/obj/item/weapon/wrench,/turf/simulated/floor/tiled/white,/area/planets/house2/indoor)
"bE" = (/obj/structure/closet/crate/large,/obj/item/stack/material/wood/fifty,/obj/item/stack/material/steel/fifty,/turf/simulated/floor/tiled/white,/area/planets/house2/indoor)
"bF" = (/obj/machinery/vending/medical,/turf/simulated/floor/tiled/white,/area/planets/house2/indoor)
"bG" = (/obj/machinery/door/airlock/glass{name = "Medical Storage"},/turf/simulated/floor/tiled/white,/area/planets/house2/indoor)
"bH" = (/obj/structure/table/steel_reinforced,/turf/simulated/floor/tiled/white,/area/planets/house2/indoor)
"bI" = (/obj/structure/closet/secure_closet/chemical,/obj/item/weapon/storage/box/pillbottles,/obj/item/device/radio/headset/headset_med,/obj/structure/table/standard,/obj/machinery/light{dir = 8},/turf/simulated/floor/tiled/white,/area/planets/house2/indoor)
"bJ" = (/obj/structure/closet/crate/large,/obj/item/stack/barbedwire/ten,/obj/item/stack/barbedwire/ten,/obj/item/stack/material/plasteel/ten,/turf/simulated/floor/tiled/white,/area/planets/house2/indoor)
"bK" = (/obj/machinery/autolathe/ammo_fabricator,/turf/simulated/floor/tiled/white,/area/planets/house2/indoor)
"bL" = (/obj/machinery/vending/armory/attachment,/turf/simulated/floor/tiled/white,/area/planets/house2/indoor)
"bM" = (/turf/simulated/open,/area/planets/house2/indoor)
"bN" = (/obj/machinery/door/airlock/medical{name = "Operation Theatre 2"},/turf/simulated/floor/tiled/white,/area/planets/house2/indoor)
"bO" = (/obj/structure/closet/secure_closet/medical2,/obj/machinery/light{dir = 8},/turf/simulated/floor/decor{tag = "icon-whitebluefull"; icon_state = "whitebluefull"},/area/planets/house2/indoor)
"bP" = (/obj/machinery/oxygen_pump/anesthetic{pixel_y = 32},/turf/simulated/floor/decor{tag = "icon-whitebluefull"; icon_state = "whitebluefull"},/area/planets/house2/indoor)
"bQ" = (/obj/structure/sink{name = "interior sink"; pixel_y = 32},/turf/simulated/floor/tiled/white,/area/planets/house2/indoor)
"bR" = (/turf/simulated/floor/decor{tag = "icon-whitebluefull"; icon_state = "whitebluefull"},/area/planets/house2/indoor)
"bS" = (/obj/machinery/iv_drip,/turf/simulated/floor/decor{tag = "icon-whitebluefull"; icon_state = "whitebluefull"},/area/planets/house2/indoor)
"bT" = (/obj/item/weapon/reagent_containers/food/snacks/popcorn,/obj/structure/table/standard,/turf/simulated/floor/decor{tag = "icon-arrival (WEST)"; icon_state = "arrival"; dir = 8},/area/planets/house2/indoor)
"bU" = (/obj/machinery/organ_printer/robot/mapped,/obj/structure/capture_marker{pixel_y = 32},/turf/simulated/floor/tiled,/area/planets/house2/indoor)
"bV" = (/obj/machinery/organ_printer/robot/mapped,/turf/simulated/floor/decor{tag = "icon-arrival (EAST)"; icon_state = "arrival"; dir = 4},/area/planets/house2/indoor)
"bW" = (/obj/structure/destructible/steel_barricade,/turf/simulated/floor/tiled/white,/area/planets/house2/indoor)
"bX" = (/obj/structure/repair_bench,/turf/simulated/floor/tiled/white,/area/planets/house2/indoor)
"bY" = (/obj/structure/table/steel,/obj/item/weapon/FixOVein,/obj/item/weapon/surgicaldrill,/turf/simulated/floor/decor{tag = "icon-whitebluefull"; icon_state = "whitebluefull"},/area/planets/house2/indoor)
"bZ" = (/turf/simulated/floor/decor{tag = "icon-whiteblue (WEST)"; icon_state = "whiteblue"; dir = 8},/area/planets/house2/indoor)
"ca" = (/turf/simulated/floor/decor{tag = "icon-whiteblue (EAST)"; icon_state = "whiteblue"; dir = 4},/area/planets/house2/indoor)
"cb" = (/obj/structure/table/steel,/obj/item/weapon/reagent_containers/spray/cleaner{desc = "Someone has crossed out the Space from Space Cleaner and written in Surgery. 'Do not remove under punishment of death!!!' is scrawled on the back."; name = "Surgery Cleaner"},/turf/simulated/floor/decor{tag = "icon-whitebluefull"; icon_state = "whitebluefull"},/area/planets/house2/indoor)
"cc" = (/obj/effect/wingrille_spawn/reinforced/full,/obj/machinery/door/blast/shutters/open{dir = 8; icon_state = "shutter1"; id = "surgery2"; name = "Surgery Shutters"; pixel_y = 0; req_access = list(45); tag = "icon-shutter1 (WEST)"},/turf/simulated/floor/tiled,/area/planets/house2/indoor)
"cd" = (/obj/structure/bed/chair{tag = "icon-chair_preview (WEST)"; icon_state = "chair_preview"; dir = 8},/turf/simulated/floor/decor{tag = "icon-arrival (WEST)"; icon_state = "arrival"; dir = 8},/area/planets/house2/indoor)
"ce" = (/obj/machinery/door/airlock/medical{name = "Observation Room"},/turf/simulated/floor/tiled,/area/planets/house2/indoor)
"cf" = (/obj/structure/table/steel,/obj/item/weapon/circular_saw{pixel_y = 8},/obj/item/weapon/scalpel,/turf/simulated/floor/decor{tag = "icon-whitebluefull"; icon_state = "whitebluefull"},/area/planets/house2/indoor)
"cg" = (/obj/machinery/optable,/turf/simulated/floor/tiled/white,/area/planets/house2/indoor)
"ch" = (/obj/structure/table/steel,/obj/item/clothing/mask/surgical,/obj/item/clothing/head/surgery/blue,/turf/simulated/floor/decor{tag = "icon-whitebluefull"; icon_state = "whitebluefull"},/area/planets/house2/indoor)
"ci" = (/obj/machinery/light{dir = 4; icon_state = "tube1"},/turf/simulated/floor/decor{tag = "icon-arrival (EAST)"; icon_state = "arrival"; dir = 4},/area/planets/house2/indoor)
"cj" = (/obj/structure/table/steel,/obj/item/stack/medical/advanced/bruise_pack,/obj/item/weapon/retractor,/obj/item/weapon/bonegel,/obj/item/weapon/bonesetter,/turf/simulated/floor/decor{tag = "icon-whitebluefull"; icon_state = "whitebluefull"},/area/planets/house2/indoor)
"ck" = (/obj/machinery/light/colored/red{icon_state = "red1"; dir = 4},/turf/simulated/floor/tiled/white,/area/planets/house2/indoor)
"cl" = (/obj/structure/destructible/marine_barricade{icon_state = "marine barricade"; dir = 1},/turf/simulated/floor/tiled/white,/area/planets/house2/indoor)
"cm" = (/obj/structure/table/steel,/obj/item/weapon/hemostat,/obj/item/weapon/cautery,/turf/simulated/floor/decor{tag = "icon-whitebluefull"; icon_state = "whitebluefull"},/area/planets/house2/indoor)
"cn" = (/obj/machinery/vending/wallmed1{pixel_y = -32},/obj/machinery/autosurgeon,/turf/simulated/floor/decor{tag = "icon-whiteblue (WEST)"; icon_state = "whiteblue"; dir = 8},/area/planets/house2/indoor)
"co" = (/obj/machinery/button/remote/blast_door{id = "surgery2"; name = "Surgery Shutters"; pixel_y = -32},/turf/simulated/floor/tiled/white,/area/planets/house2/indoor)
"cp" = (/obj/structure/table/steel,/obj/item/weapon/storage/box/bodybags,/obj/item/weapon/defibrillator/loaded,/turf/simulated/floor/decor{tag = "icon-whiteblue (EAST)"; icon_state = "whiteblue"; dir = 4},/area/planets/house2/indoor)
"cq" = (/obj/machinery/computer/med_data,/obj/machinery/light{dir = 4; icon_state = "tube1"},/turf/simulated/floor/decor{tag = "icon-whitebluefull"; icon_state = "whitebluefull"},/area/planets/house2/indoor)
"cr" = (/obj/structure/table/standard,/obj/item/weapon/reagent_containers/syringe/biofoam,/obj/item/weapon/reagent_containers/syringe/biofoam,/turf/simulated/floor/decor{tag = "icon-arrival (WEST)"; icon_state = "arrival"; dir = 8},/area/planets/house2/indoor)
"cs" = (/obj/machinery/power/breakerbox/activated,/turf/simulated/floor/tiled,/area/planets/house2/indoor)
"ct" = (/obj/structure/window/reinforced/full,/turf/simulated/floor/plating,/area/planets/house2/indoor)
"cu" = (/obj/structure/sign/greencross,/turf/simulated/wall/plastic/hospital,/area/planets/house2/indoor)
"cv" = (/obj/machinery/door/airlock/medical{name = "Medical Archives"; req_access = list(5)},/turf/simulated/floor/plating,/area/planets/house2/indoor)
"cw" = (/obj/structure/sink{icon_state = "sink"; dir = 8; pixel_x = -12; pixel_y = 2},/turf/simulated/floor/tiled/white,/area/planets/house2/indoor)
"cx" = (/obj/structure/table/standard,/obj/machinery/light{dir = 1; icon_state = "tube1"},/turf/simulated/floor/tiled/white,/area/planets/house2/indoor)
"cy" = (/obj/machinery/computer/med_data,/turf/simulated/floor/tiled/white,/area/planets/house2/indoor)
"cA" = (/obj/machinery/light{dir = 8},/turf/simulated/floor/tiled/white,/area/planets/house2/indoor)
"cB" = (/obj/structure/bed/chair/office/light,/turf/simulated/floor/tiled/white,/area/planets/house2/indoor)
"cC" = (/obj/structure/bookcase{name = "bookcase (Fiction)"},/turf/simulated/floor/tiled/white,/area/planets/house2/indoor)
"cD" = (/obj/structure/bed/chair/office/light{tag = "icon-officechair_white_preview (WEST)"; icon_state = "officechair_white_preview"; dir = 8},/turf/simulated/floor/tiled/white,/area/planets/house2/indoor)
"cE" = (/obj/structure/bed/chair/office/light{tag = "icon-officechair_white_preview (NORTH)"; icon_state = "officechair_white_preview"; dir = 1},/turf/simulated/floor/tiled/white,/area/planets/house2/indoor)
"cF" = (/obj/structure/bed/chair/office/light{tag = "icon-officechair_white_preview (EAST)"; icon_state = "officechair_white_preview"; dir = 4},/turf/simulated/floor/tiled/white,/area/planets/house2/indoor)
"cG" = (/obj/machinery/door/airlock/multi_tile/glass{name = "Meeting Room"},/turf/simulated/floor/tiled/white,/area/planets/house2/indoor)
"cH" = (/obj/structure/table/standard,/obj/machinery/light,/turf/simulated/floor/tiled/white,/area/planets/house2/indoor)
"cI" = (/obj/structure/filingcabinet/medical,/turf/simulated/floor/tiled/white,/area/planets/house2/indoor)
"cJ" = (/obj/structure/ladder/down,/turf/simulated/floor/tiled/white,/area/planets/house2/indoor)
"cK" = (/obj/structure/bookcase{name = "bookcase (Fiction)"},/obj/machinery/light{dir = 4; icon_state = "tube1"},/turf/simulated/floor/tiled/white,/area/planets/house2/indoor)
"cL" = (/obj/structure/window/framed,/turf/simulated/floor/decor{tag = "icon-cmo"; icon_state = "cmo"},/area/planets/house2/indoor)
"cM" = (/obj/effect/landmark/map_data{name = "Captured Hospital"},/turf/unsimulated/wall,/area/planets/house2/outdoor)

(1,1,1) = {"
aaaaaaaaaaaaaaaaaaaaaaaaaaaaaaaaaaaaaaaaaaaaaaaaaaaaaaaaaaaaaaaaaaaaaaaaaaaaaaaaaaaaaaaaaaaaaaaaaaaaaaaaaaaaaaaaaaaaaaaaaaaaaaaaaa
aaaaaaaaaaaaaaaaaaaaaaaaaaaaaaaaaaaaaaaaaaaaaaaaaaaaaaaaaaaaaaaaaaaaaaaaaaaaaaaaaaaaaaaaaaaaaaaaaaaaaaaaaaaaaaaaaaaaaaaaaaaaaaaaaa
aaaaaaaaaaaaaaaaaaaaaaaaaaaaaaaaaaaaaaaaaaaaaaaaaaaaaaaaaaaaaaaaaaaaaaaaaaaaaaaaaaaaaaaaaaaaaaaaaaaaaaaaaaaaaaaaaaaaaaaaaaaaaaaaaa
aaaaaaaaaaaaaaaaaaaaaaaaaaaaaaaaaaaaaaaaaaaaaaaaaaaaaaaaaaaaaaaaaaaaaaaaaaaaaaaaaaaaaaaaaaaaaaaaaaaaaaaaaaaaaaaaaaaaaaaaaaaaaaaaaa
aaaaaaaaababababababababababababababababababababababababababababababababababababababababababababababababababababababababaaaaaaaaaa
aaaaaaaaababababababababababababababababababababababababababababababababababababababababababababababababababababababababaaaaaaaaaa
aaaaaaaaababababababababababababababababababababababababababababababababababababababababababababababababababababababababaaaaaaaaaa
aaaaaaaaababababababababababababababababababababababababababababababababababababababababababababababababababababababababaaaaaaaaaa
aaaaaaaaabababababababababababacacacacacadadadadaeadadadadafagagahadadaiaiaiadadaiaiadadaiaiadadaiaiadadaiaiadajababababaaaaaaaaaa
aaaaaaaaabababababababababababacacacacacadakalamanaoapadaqarasasatauadavawawadaxawayadaxawayaeaxawayadaxawayadajababababaaaaaaaaaa
aaaaaaaaabababababababababababacacacacacaeazalamamaAawadaBalaCaDaAawaEawawawadaIawaGadaIawaHaeaIawaGadaIawaJadajababababaaaaaaaaaa
aaaaaaaaabababababababababababacacacacacadaKalaLaMaAaNadaOalaPaQaRaSadawawaTadawawawadawawawaeawawawadaTawawadajababababaaaaaaaaaa
aaaaaaaaabababababababababababacacacacacadawalaLaMaAaUadaValaWaWaAawaXawawawadadaYaYadadaYaYadadaYaYadadaYaYadajababababaaaaaaaaaa
aaaaaaaaabababababababababababacacacacacadaZalambaaAbbadbcalamamaAbdbeawawawbfawawawbgbhawawbhbibjawbhbhawawaiajababababaaaaaaaaaa
aaaaaaaaabababababababababababacacacacacadbkalamamaAbladadadbmamadadadawawawbhbnawawawboawawawawawawawawawawaiajababababaaaaaaaaaa
aaaaaaaaabababababababababababacacacacacadbpalamamaAbqaebrawawawaTbsawawawawbhbtawawawbuawawawawawawawawawawaiajababababaaaaaaaaaa
aaaaaaaaabababababababababababacacacacacadbvalbwbxaAbyaeawawawawawawawawawawbhbhawawawboawawawawawawawawawawaiajababababaaaaaaaaaa
aaaaaaaaabababababababababababacacacacacaeawalbzbAaAbBadawawawawawawawawawawbCawawawbhbhawawbhbDawbEbhbhbjawaiajababababaaaaaaaaaa
aaaaaaaaabababababababababababacacacacacaebFalamamaAawbGawawawawawawawawbrbHadadaYaYadadaYaYadadaeadadadaYaYadajababababaaaaaaaaaa
aaaaaaaaabababababababababababacacacacacadbIalamamaoaFadawawbJbKbCawawawawbLadaxawawadaxawawadbMbMbMadaxawawadajababababaaaaaaaaaa
aaaaaaaaabababababababababababacacacacacadaiaiaiadadadadbNadadadadadadawawawadaIawaGadaIawaGadbMbMbMadaIawaJadajababababaaaaaaaaaa
aaaaaaaaabababababababababababacacacacacacacacacadbObPbQbRbSadbTbUbVadbWawbWadawawayadbXawayadbMbMbMadawawayadajababababaaaaaaaaaa
aaaaaaaaabababababababababababacacacacacacacacacaibYbZawcacbcccdamaAceawawawadadaeadadadadadadbMbMbMadadadadadajababababaaaaaaaaaa
aaaaaaaaabababababababababababacacacacacacacacacaicfbZcgcachcccdbaciadawawawboawawawawawawbfawawawawawawawavaiajababababaaaaaaaaaa
aaaaaaaaabababababababababababacacacacacacacacacaicjbZawcabRcccdamaAadckawawawawawawawawawawawclawclawawawawaiajababababaaaaaaaaaa
aaaaaaaaabababababababababababacacacacacacacacacadcmcncocpcqadcrcsaAadawbrawawawawawawawavawawawbrawawawawawaiajababababaaaaaaaaaa
aaaaaaaaabababababababababababacacacacadadaiaiaiadadadadadadadadadadadadctcucvcuadadadadadadadadadadcwawawawaiajababababaaaaaaaaaa
aaaaaaaaabababababababababababababababadcxbhcyawawawbhbhbhawawawawawawawawawawawadcAawcBcBcBcBawcCadawawawawaeajababababaaaaaaaaaa
aaaaaaaaabababababababababababababababadbhcDawawawawawcEawawawawawawawawawawawbhadawcFbhbhbhbhawawawawawawawaiajababababaaaaaaaaaa
aaaaaaaaabababababababababababababababadbhawawawawawawawawawawbhcBawbhawawawcBbhadawawbhbhbhbhawawcGawawawawaiajababababaaaaaaaaaa
aaaaaaaaabababababababababababababababadbhbhcIcIcIcIcIcIcJcIcIbhbhbhbhawbhbhbhcHadawawcEcEcEcEawcKadaTawawbCadajababababaaaaaaaaaa
aaaaaaaaabababababababababababababababadadadadadadadadadadadadadadadaiaiaiaiadadadadadcLcLcLcLadadadadaeaeadadajababababaaaaaaaaaa
aaaaaaaaababababababababababababababababababababababababababababababababababababababababababababababababababababababababaaaaaaaaaa
aaaaaaaaababababababababababababababababababababababababababababababababababababababababababababababababababababababababaaaaaaaaaa
aaaaaaaaababababababababababababababababababababababababababababababababababababababababababababababababababababababababaaaaaaaaaa
aaaaaaaaababababababababababababababababababababababababababababababababababababababababababababababababababababababababaaaaaaaaaa
aaaaaaaaaaaaaaaaaaaaaaaaaaaaaaaaaaaaaaaaaaaaaaaaaaaaaaaaaaaaaaaaaaaaaaaaaaaaaaaaaaaaaaaaaaaaaaaaaaaaaaaaaaaaaaaaaaaaaaaaaaaaaaaaaa
aaaaaaaaaaaaaaaaaaaaaaaaaaaaaaaaaaaaaaaaaaaaaaaaaaaaaaaaaaaaaaaaaaaaaaaaaaaaaaaaaaaaaaaaaaaaaaaaaaaaaaaaaaaaaaaaaaaaaaaaaaaaaaaaaa
aaaaaaaaaaaaaaaaaaaaaaaaaaaaaaaaaaaaaaaaaaaaaaaaaaaaaaaaaaaaaaaaaaaaaaaaaaaaaaaaaaaaaaaaaaaaaaaaaaaaaaaaaaaaaaaaaaaaaaaaaaaaaaaaaa
cMaaaaaaaaaaaaaaaaaaaaaaaaaaaaaaaaaaaaaaaaaaaaaaaaaaaaaaaaaaaaaaaaaaaaaaaaaaaaaaaaaaaaaaaaaaaaaaaaaaaaaaaaaaaaaaaaaaaaaaaaaaaaaaaa
"}
